name	taxonomy_id	taxonomy_lvl	kraken_assigned_reads	added_reads	new_est_reads	fraction_total_reads
Gammaproteobacteria bacterium	1913989	S	1076251	500477	1576728	0.04997
gamma proteobacterium SCGC AAA007-O20	913327	S	86319	112601	198920	0.00630
Gammaproteobacteria bacterium UBA1119	1948582	S	29666	63096	92762	0.00294
gamma proteobacterium SCGC AB-629-P17	1131274	S	17650	43119	60769	0.00193
Gammaproteobacteria bacterium REDSEA-S15_B12	1811666	S	12169	18538	30707	0.00097
Gammaproteobacteria bacterium UBA7310	1948647	S	4995	3283	8278	0.00026
Gammaproteobacteria bacterium UBA3532	1948611	S	2548	3309	5857	0.00019
Gammaproteobacteria bacterium F7	1813817	S	384	91	475	0.00002
Gammaproteobacteria bacterium UBA1961	1948588	S	341	132	473	0.00001
Gammaproteobacteria bacterium UBA7803	1948658	S	285	709	994	0.00003
Gammaproteobacteria bacterium UBA6940	1948640	S	187	57	244	0.00001
Gammaproteobacteria bacterium UBA2675	1948596	S	176	2987	3163	0.00010
Gammaproteobacteria bacterium UBA7376	1948649	S	117	6	123	0.00000
Gammaproteobacteria bacterium UBA3498	1948609	S	75	25	100	0.00000
gamma proteobacterium HdN1	83406	S	50	53	103	0.00000
Gammaproteobacteria bacterium TMED225	1986748	S	47	59	106	0.00000
gamma proteobacterium SCGC AAA168-P09	1009426	S	25	23	48	0.00000
Gammaproteobacteria bacterium MFB021	1492922	S	12	51	63	0.00000
Alteromonas australica	589873	S	153395	94918	248313	0.00787
Alteromonas macleodii	28108	S	102130	208106	310236	0.00983
Alteromonas mediterranea	314275	S	67879	122898	190777	0.00605
Alteromonas sp. IB21	2779369	S	8344	9426	17770	0.00056
Alteromonas sp. RKMC-009	2267264	S	329	83	412	0.00001
Alteromonas sp. 38	2653129	S	231	235	466	0.00001
Alteromonas sp. ALT199	1298865	S	196	218	414	0.00001
Alteromonas sp. KC3	2795688	S	178	56	234	0.00001
Alteromonas sp. KUL106	2480799	S	134	56	190	0.00001
Alteromonas sp. KUL42	2480797	S	126	19	145	0.00000
Alteromonas sp. BL110	1714845	S	124	173	297	0.00001
Alteromonas sp. MMG017	2822692	S	124	110	234	0.00001
Alteromonas sp. V450	1912139	S	98	76	174	0.00001
Alteromonas sp. C1M14	2841567	S	57	4	61	0.00000
Alteromonas sp. LOR	1537994	S	16	11	27	0.00000
Alteromonas sp. 5E99-2	2817683	S	12	0	12	0.00000
Alteromonas alba	2079529	S	7433	67042	74475	0.00236
Alteromonas abrolhosensis	1892904	S	5295	6993	12288	0.00039
Alteromonas marina	203795	S	3656	6607	10263	0.00033
Alteromonas oceani	2071609	S	3497	18011	21508	0.00068
Alteromonas naphthalenivorans	715451	S	2822	5731	8553	0.00027
Alteromonas profundi	2696062	S	1619	1177	2796	0.00009
Alteromonas antoniana	2803813	S	1616	2120	3736	0.00012
Alteromonas portus	2565549	S	1334	1431	2765	0.00009
Alteromonas oceanisediminis	2836180	S	1192	368	1560	0.00005
Alteromonas gracilis	1479524	S	308	225	533	0.00002
Alteromonas lipotrueiana	2803815	S	232	66	298	0.00001
Alteromonas stellipolaris	233316	S	195	224	419	0.00001
Alteromonas hispanica	315421	S	189	32	221	0.00001
Alteromonas genovensis	471225	S	140	112	252	0.00001
Alteromonas pelagimontana	1858656	S	97	23	120	0.00000
Alteromonas lipolytica	1856405	S	46	9	55	0.00000
Alteromonas halophila	516698	S	19	4	23	0.00000
Alteromonas flava	2048003	S	18	1	19	0.00000
Salinimonas sediminis	2303538	S	133	122	255	0.00001
Salinimonas chungwhensis	265425	S	112	19	131	0.00000
Salinimonas profundi	2729140	S	82	60	142	0.00000
Salinimonas lutimaris	914153	S	14	5	19	0.00000
Alteromonadaceae bacterium UBA2620	1951386	S	80392	342635	423027	0.01341
Alteromonadaceae bacterium	1916082	S	2993	2039	5032	0.00016
Alteromonadaceae bacterium XY-R5	1737567	S	19	1	20	0.00000
Paraglaciecola mesophila	197222	S	1478	798	2276	0.00007
Paraglaciecola arctica	1128911	S	80	6	86	0.00000
Paraglaciecola chathamensis	368405	S	48	16	64	0.00000
Paraglaciecola polaris	222814	S	27	17	44	0.00000
Marisediminitalea aggregata	634436	S	456	68	524	0.00002
Glaciecola sp. UBA1851	1946570	S	140	29	169	0.00001
Glaciecola sp. HTCC2999	455436	S	65	11	76	0.00000
Glaciecola sp. XM2	1914931	S	31	1	32	0.00000
Aliiglaciecola lipolytica	477689	S	195	138	333	0.00001
Neptunicella marina	2125989	S	91	21	112	0.00000
Aestuariibacter sp. A3R04	2841571	S	35	7	42	0.00000
Aestuariibacter sp.	1872400	S	12	2	14	0.00000
Ningiella ruwaisensis	2364274	S	37	21	58	0.00000
Hydrocarboniclastica marina	2259620	S	31	11	42	0.00000
Pseudoalteromonas sp. MEBiC 03607	2563601	S	27131	43921	71052	0.00225
Pseudoalteromonas sp. NBT06-2	2025950	S	317	16	333	0.00001
Pseudoalteromonas sp. H71	1348395	S	160	120	280	0.00001
Pseudoalteromonas sp.	53249	S	107	204	311	0.00001
Pseudoalteromonas sp. '520P1 No. 423'	1690037	S	104	22	126	0.00000
Pseudoalteromonas sp. 0303	2743618	S	74	356	430	0.00001
Pseudoalteromonas sp. P1-25	1723758	S	48	34	82	0.00000
Pseudoalteromonas sp. DL-6	1390185	S	46	94	140	0.00000
Pseudoalteromonas sp. T1lg23B	2077097	S	36	9	45	0.00000
Pseudoalteromonas sp. EB27	1938368	S	16	34	50	0.00000
Pseudoalteromonas sp. XI10	1766621	S	13	55	68	0.00000
Pseudoalteromonas atlantica	288	S	6295	6598	12893	0.00041
Pseudoalteromonas lipolytica	570156	S	2900	3963	6863	0.00022
Pseudoalteromonas shioyasakiensis	1190813	S	673	2655	3328	0.00011
Pseudoalteromonas tetraodonis	43659	S	511	1159	1670	0.00005
Pseudoalteromonas arabiensis	874454	S	290	117	407	0.00001
Pseudoalteromonas marina	267375	S	114	103	217	0.00001
Pseudoalteromonas prydzensis	182141	S	91	59	150	0.00000
Pseudoalteromonas gelatinilytica	1703256	S	88	175	263	0.00001
Pseudoalteromonas distincta	77608	S	49	157	206	0.00001
Pseudoalteromonas carrageenovora	227	S	41	58	99	0.00000
Pseudoalteromonas undina	43660	S	37	76	113	0.00000
Pseudoalteromonas nigrifaciens	28109	S	25	68	93	0.00000
Algicola sp.	1872429	S	80	51	131	0.00000
Idiomarina loihiensis	135577	S	3358	2138	5496	0.00017
Idiomarina baltica	190892	S	1412	1899	3311	0.00010
Idiomarina aquatica	1327752	S	954	495	1449	0.00005
Idiomarina abyssalis	86102	S	676	524	1200	0.00004
Idiomarina seosinensis	281739	S	440	172	612	0.00002
Idiomarina zobellii	86103	S	271	468	739	0.00002
Idiomarina piscisalsi	1096243	S	61	68	129	0.00000
Idiomarina sp. MD25a	1889913	S	21	21	42	0.00000
Idiomarina fontislapidosi	263723	S	26	9	35	0.00000
Idiomarina ramblicola	263724	S	14	2	16	0.00000
Idiomarinaceae bacterium	1898113	S	1014	1090	2104	0.00007
Pseudidiomarina maritima	519453	S	37	65	102	0.00000
Pseudidiomarina aquimaris	641841	S	14	14	28	0.00000
Litorilituus sediminis	718192	S	148	25	173	0.00001
Colwellia sp.	56799	S	12	7	19	0.00000
Shewanella sp. 10N.286.51.B7	1880836	S	28	47	75	0.00000
Shewanella algidipiscicola	614070	S	13	16	29	0.00000
Motilimonas pumila	2303987	S	20	15	35	0.00000
Psychromonas arctica	168275	S	13	9	22	0.00000
Candidatus Thioglobus sp. MED-G25	1986229	S	335097	240811	575908	0.01825
Candidatus Thioglobus sp.	2026721	S	112	144	256	0.00001
Candidatus Thioglobus sp. NP1	2508687	S	30	22	52	0.00000
uncultured Candidatus Thioglobus sp.	655186	S	3251	6063	9314	0.00030
Candidatus Thioglobus autotrophicus	1705394	S	112	30	142	0.00000
uncultured SAR86 cluster bacterium	648174	S	54161	18666	72827	0.00231
SAR86 cluster bacterium REDSEA-S09_B4	1811643	S	47208	4449	51657	0.00164
SAR86 cluster bacterium AG-339-G14	2162562	S	247	88	335	0.00001
SAR86 cluster bacterium	2030880	S	35	19	54	0.00000
SAR86 cluster bacterium SAR86B	1123867	S	30	25	55	0.00000
SAR86 cluster bacterium AG-349-I13	2162563	S	14	10	24	0.00000
OM182 bacterium MED-G28	1986256	S	123	27	150	0.00000
K189A clade bacterium	2315472	S	103	75	178	0.00001
uncultured Pseudohongiella sp.	1772216	S	84	118	202	0.00001
Pseudohongiella nitratireducens	1768907	S	26	33	59	0.00000
Candidatus Pseudothioglobus singularis	1427364	S	20	9	29	0.00000
Marinobacter nauticus	2743	S	29063	22021	51084	0.00162
Marinobacter vinifirmus	355591	S	5175	10206	15381	0.00049
Marinobacter manganoxydans	1150997	S	3601	56722	60323	0.00191
Marinobacter sp. B9-2	2137198	S	861	3547	4408	0.00014
Marinobacter sp. Arc7-DN-1	2304594	S	472	720	1192	0.00004
Marinobacter sp.	50741	S	345	337	682	0.00002
Marinobacter sp. LQ44	1749259	S	292	836	1128	0.00004
Marinobacter sp. EhC06	1849169	S	125	265	390	0.00001
Marinobacter sp. NP-4(2019)	2488665	S	105	34	139	0.00000
Marinobacter sp. es.042	1761794	S	103	312	415	0.00001
Marinobacter sp. AC-23	1879031	S	49	9	58	0.00000
Marinobacter sp. es.048	1761795	S	39	25	64	0.00000
Marinobacter sp. BW6	2592624	S	38	40	78	0.00000
Marinobacter sp. 1-4A	2582919	S	22	20	42	0.00000
Marinobacter sp. F3R08	2841559	S	17	8	25	0.00000
Marinobacter fuscus	2109942	S	2322	4370	6692	0.00021
Marinobacter segnicrescens	430453	S	2119	1350	3469	0.00011
Marinobacter flavimaris	262076	S	1153	18492	19645	0.00062
Marinobacter salsuginis	418719	S	771	1030	1801	0.00006
Marinobacter lutaoensis	135739	S	515	277	792	0.00003
Marinobacter adhaerens	1033846	S	340	2786	3126	0.00010
Marinobacter lipolyticus	209639	S	336	279	615	0.00002
Marinobacter salarius	1420917	S	303	689	992	0.00003
Marinobacter persicus	930118	S	246	333	579	0.00002
Marinobacter shengliensis	1389223	S	216	339	555	0.00002
Marinobacter litoralis	187981	S	131	32	163	0.00001
Marinobacter pelagius	379482	S	67	46	113	0.00000
Marinobacter profundi	2666256	S	58	42	100	0.00000
Marinobacter denitrificans	2597703	S	58	80	138	0.00000
Marinobacter antarcticus	564117	S	57	25	82	0.00000
Marinobacter maroccanus	2055143	S	51	67	118	0.00000
Marinobacter oulmenensis	643747	S	47	8	55	0.00000
Marinobacter aromaticivorans	1494078	S	33	14	47	0.00000
Marinobacter santoriniensis	523742	S	23	4	27	0.00000
Marinobacter algicola	236100	S	23	27	50	0.00000
Marinobacter excellens	218670	S	15	20	35	0.00000
Marinobacter piscensis	1562308	S	13	9	22	0.00000
Marinobacter guineae	432303	S	12	9	21	0.00000
Pseudomonas sp.	306	S	33677	53930	87607	0.00278
Pseudomonas sp. SSM44	2487347	S	7484	6872	14356	0.00045
Pseudomonas sp. NBRC 111131	1661046	S	38	111	149	0.00000
Pseudomonas sp. AOB-7	2482750	S	18	10	28	0.00000
Pseudomonas marincola	437900	S	275	46	321	0.00001
Pseudomonas tohonis	2725477	S	197	152	349	0.00001
Pseudomonas saliphila	2586906	S	171	62	233	0.00001
Pseudomonas putida	303	S	57	87	144	0.00000
Pseudomonas mendocina	300	S	38	33	71	0.00000
Pseudomonas peli	592361	S	50	78	128	0.00000
Pseudomonas bharatica	2692112	S	34	95	129	0.00000
Pseudomonas profundi	1981513	S	25	23	48	0.00000
Pseudomonas chengduensis	489632	S	17	51	68	0.00000
Pseudomonas juntendi	2666183	S	12	21	33	0.00000
Halopseudomonas aestusnigri	857252	S	22360	16361	38721	0.00123
Halopseudomonas pachastrellae	254161	S	2130	1676	3806	0.00012
Halopseudomonas gallaeciensis	857227	S	1740	1208	2948	0.00009
Halopseudomonas sabulinigri	472181	S	1182	201	1383	0.00004
Halopseudomonas pelagia	553151	S	1141	549	1690	0.00005
Halopseudomonas oceani	1708783	S	491	413	904	0.00003
Halopseudomonas salina	1323744	S	73	9	82	0.00000
Halopseudomonas formosensis	1002526	S	40	31	71	0.00000
Halopseudomonas bauzanensis	653930	S	33	35	68	0.00000
Halopseudomonas xinjiangensis	487184	S	27	14	41	0.00000
Halopseudomonas salegens	1434072	S	23	3	26	0.00000
Halopseudomonas litoralis	797277	S	15	7	22	0.00000
Halopseudomonas yangmingensis	1720063	S	13	9	22	0.00000
Pseudomonadaceae bacterium UBA836	1952795	S	244	63	307	0.00001
Pseudomonadaceae bacterium SI-3	2079806	S	15	13	28	0.00000
Stutzerimonas stutzeri	316	S	186	177	363	0.00001
Stutzerimonas xanthomarina	271420	S	19	122	141	0.00000
Pseudomonadales bacterium	1891229	S	149	67	216	0.00001
Halomonas aquamarina	77097	S	11028	52600	63628	0.00202
Halomonas taeanensis	284577	S	7447	3437	10884	0.00034
Halomonas sp.	1486246	S	2986	1913	4899	0.00016
Halomonas sp. UBA3074	1946584	S	640	912	1552	0.00005
Halomonas sp. A40-4	2785909	S	496	595	1091	0.00003
Halomonas sp. 54_146	1635257	S	56	70	126	0.00000
Halomonas sp. HAL1	550984	S	31	80	111	0.00000
Halomonas sedimenti	2729618	S	1492	2680	4172	0.00013
Halomonas lionensis	1144478	S	1240	4347	5587	0.00018
Halomonas salina	42565	S	912	1715	2627	0.00008
Halomonas sulfidaeris	115553	S	778	319	1097	0.00003
Halomonas piezotolerans	2609667	S	759	1053	1812	0.00006
Halomonas salicampi	1449798	S	574	212	786	0.00002
Halomonas meridiana	29570	S	483	795	1278	0.00004
Halomonas zincidurans	1178777	S	204	142	346	0.00001
Halomonas titanicae	664683	S	171	457	628	0.00002
Halomonas alkaliantarctica	232346	S	102	147	249	0.00001
Halomonas hamiltonii	502829	S	78	248	326	0.00001
Halomonas nanhaiensis	1258546	S	75	73	148	0.00000
Halomonas glaciei	186761	S	67	221	288	0.00001
Halomonas maris	2729617	S	57	179	236	0.00001
Halomonas stevensii	502821	S	56	263	319	0.00001
Halomonas ilicicola	480814	S	41	11	52	0.00000
Halomonas lutescens	1602943	S	37	16	53	0.00000
Halomonas venusta	44935	S	34	18	52	0.00000
Halomonas alkaliphila	272774	S	26	35	61	0.00000
Halomonas litopenaei	2109328	S	25	27	52	0.00000
Halomonas azerica	2732867	S	23	7	30	0.00000
Halomonas niordiana	2508711	S	19	27	46	0.00000
Halomonas ventosae	229007	S	18	25	43	0.00000
Halomonas alimentaria	147248	S	16	25	41	0.00000
Halomonas xianhensis	442341	S	16	8	24	0.00000
Halomonas salipaludis	2032625	S	13	19	32	0.00000
Salinicola salarius	430457	S	5145	5140	10285	0.00033
Salinicola sp.	1978524	S	102	277	379	0.00001
Salinicola peritrichatus	1267424	S	55	44	99	0.00000
Salinicola corii	2606937	S	47	88	135	0.00000
Cobetia amphilecti	1055104	S	1538	1350	2888	0.00009
Cobetia crustatorum	553385	S	64	53	117	0.00000
Cobetia marina	28258	S	21	17	38	0.00000
Chromohalobacter israelensis	141390	S	125	166	291	0.00001
Chromohalobacter salexigens	158080	S	19	31	50	0.00000
Chromohalobacter canadensis	141389	S	15	16	31	0.00000
Alloalcanivorax venustensis	172371	S	10360	41833	52193	0.00165
Alloalcanivorax profundimaris	2735259	S	1937	3251	5188	0.00016
Alloalcanivorax gelatiniphagus	1194167	S	1661	1908	3569	0.00011
Alloalcanivorax marinus	1177169	S	107	102	209	0.00001
Alloalcanivorax mobilis	2019569	S	102	36	138	0.00000
Alloalcanivorax dieselolei	285091	S	20	22	42	0.00000
Alcanivorax sp. DSM 26293	1798238	S	1412	2460	3872	0.00012
Alcanivorax sp.	1872427	S	983	1012	1995	0.00006
Alcanivorax sp. UBA4485	1945988	S	715	1066	1781	0.00006
Alcanivorax sp. 24	2545266	S	75	88	163	0.00001
Alcanivorax sp. DG881	236097	S	42	52	94	0.00000
Alcanivorax jadensis	64988	S	2041	1642	3683	0.00012
Alcanivorax hongdengensis	519051	S	195	154	349	0.00001
Alcanivorax borkumensis	59754	S	86	49	135	0.00000
Alcanivorax nanhaiticus	1177154	S	13	24	37	0.00000
Alcanivoracaceae bacterium	2024895	S	671	1016	1687	0.00005
Ketobacter sp.	2083498	S	265	91	356	0.00001
Isoalcanivorax pacificus	1306787	S	13	17	30	0.00000
Oceanospirillaceae bacterium	1899355	S	7950	3032	10982	0.00035
Oceanospirillaceae bacterium UBA1126	1952987	S	12	0	12	0.00000
Thalassolituus sp. UBA1087	1947651	S	1643	258	1901	0.00006
Thalassolituus sp. UBA2107	1947659	S	749	496	1245	0.00004
Thalassolituus sp. C2-1	2597518	S	95	54	149	0.00000
Thalassolituus sp. UBA674	1947666	S	79	40	119	0.00000
Thalassolituus oleivorans	187493	S	1836	1495	3331	0.00011
Neptuniibacter sp. UBA6509	1946976	S	2049	565	2614	0.00008
Neptuniibacter pectenicola	1806669	S	292	124	416	0.00001
Marinobacterium iners	48076	S	191	29	220	0.00001
Marinobacterium litorale	404770	S	144	68	212	0.00001
Marinobacterium sp. A346	2851016	S	13	3	16	0.00000
Oceanobacter sp.	2030817	S	135	66	201	0.00001
Bermanella sp.	2024825	S	85	93	178	0.00001
Oleispira sp.	2024846	S	73	37	110	0.00000
Marinomonas profundimaris	1208321	S	31	59	90	0.00000
Oleiphilus sp.	2025907	S	63	8	71	0.00000
Endozoicomonas sp. G2_2	2821092	S	45	73	118	0.00000
Acidiferrobacteraceae bacterium	2024893	S	112579	131704	244283	0.00774
uncultured Gammaproteobacteria bacterium	86473	S	41152	14315	55467	0.00176
Psychrobacter submarinus	154108	S	18715	16976	35691	0.00113
Psychrobacter sp. Cmf 22.2	1926478	S	576	230	806	0.00003
Psychrobacter sp. UBA3480	1947350	S	110	211	321	0.00001
Psychrobacter sp. Choline-02u-9	2058310	S	42	209	251	0.00001
Psychrobacter sp. Pi2-1	2774131	S	16	37	53	0.00000
Psychrobacter sp.	56811	S	12	0	12	0.00000
Psychrobacter celer	306572	S	127	95	222	0.00001
Psychrobacter piscatorii	554343	S	87	116	203	0.00001
Psychrobacter pacificensis	112002	S	87	193	280	0.00001
Psychrobacter coccoides	2818440	S	42	12	54	0.00000
Psychrobacter immobilis	498	S	36	97	133	0.00000
Psychrobacter fulvigenes	533323	S	25	22	47	0.00000
Psychrobacter faecalis	180588	S	19	13	32	0.00000
Psychrobacter proteolyticus	147825	S	14	27	41	0.00000
Psychrobacter namhaensis	292734	S	14	4	18	0.00000
Acinetobacter variabilis	70346	S	460	893	1353	0.00004
Acinetobacter ursingii	108980	S	399	753	1152	0.00004
Acinetobacter venetianus	52133	S	182	133	315	0.00001
Acinetobacter johnsonii	40214	S	53	133	186	0.00001
Acinetobacter baumannii	470	S	12	36	48	0.00000
Acinetobacter lwoffii	28090	S	29	277	306	0.00001
Acinetobacter junii	40215	S	25	66	91	0.00000
Acinetobacter towneri	202956	S	21	54	75	0.00000
Acinetobacter brisouii	396323	S	15	18	33	0.00000
Moraxellaceae bacterium REDSEA-S32_B1	1811612	S	26	6	32	0.00000
Xanthomonadales bacterium	2006849	S	27213	6847	34060	0.00108
Stenotrophomonas maltophilia	40324	S	24	75	99	0.00000
Woeseiaceae bacterium	2026806	S	19562	17964	37526	0.00119
uncultured Woeseiaceae bacterium	1983305	S	99	8	107	0.00000
Woeseia sp.	1980636	S	16	1	17	0.00000
Rheinheimera aquimaris	412437	S	393	224	617	0.00002
Arsukibacterium sp. UBA3155	1946058	S	186	55	241	0.00001
Arsukibacterium sp. UBA5043	1946062	S	16	4	20	0.00000
Allochromatium humboldtianum	504901	S	30	17	47	0.00000
Chromatiales bacterium	2026725	S	220	32	252	0.00001
Spongiibacter marinus	354246	S	4801	4163	8964	0.00028
Spongiibacter tropicus	454602	S	1424	1318	2742	0.00009
Spongiibacter sp. IMCC21906	1620392	S	50	30	80	0.00000
Spongiibacter pelagi	2760804	S	39	49	88	0.00000
Spongiibacter thalassae	2721624	S	26	5	31	0.00000
Spongiibacteraceae bacterium	2026793	S	96	18	114	0.00000
Sinobacterium caligoides	933926	S	39	0	39	0.00000
Porticoccaceae bacterium UBA1117	1952748	S	381	45	426	0.00001
Porticoccaceae bacterium	2026782	S	324	162	486	0.00002
uncultured SAR92 cluster bacterium	1118066	S	264	69	333	0.00001
gamma proteobacterium HTCC2207	314287	S	23	4	27	0.00000
SAR92 clade bacterium	2315479	S	21	9	30	0.00000
Porticoccus hydrocarbonoclasticus	1073414	S	69	135	204	0.00001
Porticoccus sp.	2024853	S	17	18	35	0.00000
Congregibacter litoralis	393662	S	525	531	1056	0.00003
Halioglobus sp.	2024834	S	348	166	514	0.00002
Halioglobus pacificus	930806	S	72	9	81	0.00000
Halieaceae bacterium	2026743	S	75	17	92	0.00000
Halieaceae bacterium UBA5085	1951918	S	48	23	71	0.00000
Haliea sp.	1932666	S	40	4	44	0.00000
Haliea salexigens	287487	S	15	22	37	0.00000
Cellvibrio mixtus	39650	S	301	7	308	0.00001
Gilvimarinus agarilyticus	679259	S	15	1	16	0.00000
Marinimicrobium koreense	306545	S	13	0	13	0.00000
Thiotrichales bacterium	2026796	S	4291	945	5236	0.00017
Methylophaga sp.	2024840	S	1653	895	2548	0.00008
Methylophaga sp. UBA2689	1946878	S	85	302	387	0.00001
Methylophaga aminisulfidivorans	230105	S	49	67	116	0.00000
Methylophaga nitratireducenticrescens	754476	S	15	25	40	0.00000
Cycloclasticus sp.	2024830	S	242	127	369	0.00001
uncultured Francisellaceae bacterium	393692	S	1502	23	1525	0.00005
Francisella adeliensis	2007306	S	31	7	38	0.00000
Thiotrichaceae bacterium	2030882	S	113	18	131	0.00000
uncultured Thiothrix sp.	223185	S	44	6	50	0.00000
Salinisphaera shabanensis	180542	S	6814	3892	10706	0.00034
Salinisphaera sp. UBA6602	1947455	S	746	695	1441	0.00005
Salinisphaera sp.	1914330	S	123	76	199	0.00001
Salinisphaera halophila	1304158	S	31	84	115	0.00000
Salinisphaera japonica	1304270	S	28	32	60	0.00000
Salinisphaera hydrothermalis	563188	S	17	4	21	0.00000
Salinisphaera orenii	856731	S	17	40	57	0.00000
Salinisphaeraceae bacterium	2026789	S	26	1	27	0.00000
Legionellales bacterium	2026754	S	2560	592	3152	0.00010
Legionella sp.	459	S	12	10	22	0.00000
Legionella impletisoli	343510	S	14	14	28	0.00000
Coxiellaceae bacterium	2026727	S	23	1	24	0.00000
Photobacterium sp. SKA34	121723	S	398	1011	1409	0.00004
Photobacterium angustum	661	S	86	245	331	0.00001
Photobacterium kishitanii	318456	S	32	29	61	0.00000
Vibrio sp. AND4	314289	S	103	85	188	0.00001
Vibrio mytili	50718	S	82	221	303	0.00001
Vibrio campbellii	680	S	44	150	194	0.00001
Vibrio sagamiensis	512650	S	16	22	38	0.00000
Vibrio hibernica	2587465	S	15	31	46	0.00000
Paraphotobacterium marinum	1755811	S	30	14	44	0.00000
Escherichia coli	562	S	22	323	345	0.00001
Enterobacteriaceae bacterium JKS000234	1938870	S	30	83	113	0.00000
Leclercia adecarboxylata	83655	S	21	91	112	0.00000
Providencia huaxiensis	2027290	S	282	338	620	0.00002
Pantoea dispersa	59814	S	25	42	67	0.00000
Pantoea eucrina	472693	S	12	12	24	0.00000
Methylococcaceae bacterium UBA1147	1952219	S	535	136	671	0.00002
Methylococcales bacterium OPU3_GD_OMZ	1920888	S	486	111	597	0.00002
Mannheimia sp. USDA-ARS-USMARC-1261	1432056	S	89	47	136	0.00000
Polycyclovorans sp.	2024852	S	47	107	154	0.00000
Tolumonas sp.	1978237	S	15	10	25	0.00000
Pelagibacteraceae bacterium	2026775	S	63903	78261	142164	0.00451
alpha proteobacterium SCGC AAA288-G21	939324	S	36016	110755	146771	0.00465
Pelagibacteraceae bacterium AG-464-P07	2162008	S	28819	50461	79280	0.00251
alpha proteobacterium SCGC AAA288-N07	939346	S	13303	33333	46636	0.00148
alpha proteobacterium SCGC AAA240-E13	939306	S	7234	29167	36401	0.00115
Pelagibacteraceae bacterium AG-464-B04	2162007	S	4453	2802	7255	0.00023
alpha proteobacterium SCGC AAA288-E13	939316	S	3818	23060	26878	0.00085
Pelagibacteraceae bacterium AG-470-E16	2162009	S	288	68	356	0.00001
Pelagibacteraceae bacterium AG-470-G21	2162011	S	204	837	1041	0.00003
Pelagibacteraceae bacterium AG-414-E02	2162014	S	165	191	356	0.00001
Pelagibacteraceae bacterium AG-430-I06	2162019	S	38	51	89	0.00000
Pelagibacteraceae bacterium AG-414-M23	2162016	S	35	52	87	0.00000
Pelagibacteraceae bacterium AG-426-I15	2161996	S	30	65	95	0.00000
Pelagibacteraceae bacterium AG-439-F23	2162002	S	27	42	69	0.00000
Pelagibacteraceae bacterium AG-337-G04	2162031	S	25	199	224	0.00001
Pelagibacteraceae bacterium AG-390-C22	2161986	S	24	96	120	0.00000
Pelagibacteraceae bacterium AG-404-N13	2161987	S	23	38	61	0.00000
Pelagibacteraceae bacterium AG-426-L23	2161997	S	18	43	61	0.00000
Pelagibacteraceae bacterium AG-430-F16	2162054	S	18	171	189	0.00001
Pelagibacteraceae bacterium AG-325-C03	2162021	S	17	34	51	0.00000
Pelagibacteraceae bacterium AG-337-I02	2162033	S	17	199	216	0.00001
Pelagibacteraceae bacterium AG-426-E17	2161995	S	16	83	99	0.00000
Pelagibacteraceae bacterium AG-345-F21	2162037	S	15	17	32	0.00000
Pelagibacteraceae bacterium AG-319-F18	2162057	S	15	152	167	0.00001
uncultured Pelagibacteraceae bacterium	1667051	S	311741	1009649	1321390	0.04188
Candidatus Pelagibacter sp.	2024849	S	19888	44943	64831	0.00205
Candidatus Pelagibacter sp. TMED239	1986816	S	12	100	112	0.00000
uncultured Candidatus Pelagibacter sp.	372654	S	712	632	1344	0.00004
Candidatus Pelagibacter ubique	198252	S	248	2642	2890	0.00009
Candidatus Pelagibacter giovannonii	2563896	S	15	18	33	0.00000
Pelagibacterales bacterium	2026776	S	36545	88572	125117	0.00396
Pelagibacterales bacterium SAG-MED29	2760031	S	33	166	199	0.00001
Pelagibacterales bacterium SAG-MED31	2760033	S	22	37	59	0.00000
Pelagibacterales bacterium MED-G40	1986248	S	14	33	47	0.00000
Alphaproteobacteria bacterium MarineAlpha3_Bin6	2013072	S	149325	23071	172396	0.00546
Alphaproteobacteria bacterium MarineAlpha5_Bin3	2013078	S	119262	15445	134707	0.00427
Alphaproteobacteria bacterium MarineAlpha3_Bin4	2013070	S	60705	3858	64563	0.00205
Alphaproteobacteria bacterium MarineAlpha3_Bin3	2013069	S	55410	31601	87011	0.00276
Alphaproteobacteria bacterium	1913988	S	26841	12190	39031	0.00124
Alphaproteobacteria bacterium MarineAlpha10_Bin2	2013104	S	26096	1483	27579	0.00087
Alphaproteobacteria bacterium MarineAlpha9_Bin7	2013102	S	6029	864	6893	0.00022
Alphaproteobacteria bacterium MarineAlpha6_Bin2	2013089	S	3375	300	3675	0.00012
Alphaproteobacteria bacterium MarineAlpha9_Bin1	2013096	S	1103	147	1250	0.00004
Alphaproteobacteria bacterium MarineAlpha9_Bin6	2013101	S	788	16	804	0.00003
Alphaproteobacteria bacterium MarineAlpha5_Bin5	2013080	S	659	125	784	0.00002
Alphaproteobacteria bacterium MarineAlpha3_Bin2	2013068	S	328	62	390	0.00001
Alphaproteobacteria bacterium MarineAlpha3_Bin7	2013073	S	139	14	153	0.00000
Alphaproteobacteria bacterium MarineAlpha5_Bin12	2013087	S	95	93	188	0.00001
Alphaproteobacteria bacterium UBA6544	1948430	S	82	41	123	0.00000
Alphaproteobacteria bacterium MarineAlpha6_Bin4	2013091	S	62	30	92	0.00000
Alphaproteobacteria bacterium MarineAlpha5_Bin7	2013082	S	43	3	46	0.00000
Alphaproteobacteria bacterium HT1-32	2665153	S	43	1	44	0.00000
alpha proteobacterium SCGC AAA015-N04	939296	S	36	218	254	0.00001
Alphaproteobacteria bacterium UBA828	1948450	S	30	1	31	0.00000
Alphaproteobacteria bacterium MarineAlpha10_Bin3	2013105	S	26	4	30	0.00000
Alphaproteobacteria bacterium UBA2964	1948376	S	15	162	177	0.00001
Erythrobacter sp. A30-3	2785907	S	92178	109600	201778	0.00639
Erythrobacter sp.	1042	S	26094	21542	47636	0.00151
Erythrobacter sp. HI0063	1822240	S	1898	2258	4156	0.00013
Erythrobacter sp. 3-20A1M	2653850	S	1482	1074	2556	0.00008
Erythrobacter sp. UBA2510	1946470	S	320	773	1093	0.00003
Erythrobacter sp. SD-21	161528	S	52	29	81	0.00000
Erythrobacter sp. UBA1916	1946469	S	29	37	66	0.00000
Erythrobacter aureus	2182384	S	6705	3514	10219	0.00032
Erythrobacter longus	1044	S	512	73	585	0.00002
Erythrobacter litoralis	39960	S	495	651	1146	0.00004
Porphyrobacter sp. CACIAM 03H1	2003315	S	39	20	59	0.00000
Qipengyuania citrea	225971	S	35589	45689	81278	0.00258
Qipengyuania vulgaris	291985	S	849	506	1355	0.00004
Qipengyuania pelagi	994320	S	431	420	851	0.00003
Qipengyuania flava	192812	S	146	51	197	0.00001
Qipengyuania nanhaisediminis	604088	S	121	117	238	0.00001
Qipengyuania seohaensis	266951	S	15	8	23	0.00000
Qipengyuania sp. YIM B01966	2778646	S	15	8	23	0.00000
Croceicoccus sp.	1927144	S	795	2578	3373	0.00011
Croceicoccus sp. YJ47	2798724	S	44	27	71	0.00000
Croceicoccus marinus	450378	S	22	22	44	0.00000
Croceicoccus gelatinilyticus	2835536	S	12	9	21	0.00000
Aurantiacibacter atlanticus	1648404	S	482	127	609	0.00002
Aurantiacibacter zhengii	2307003	S	370	368	738	0.00002
Aurantiacibacter odishensis	1155476	S	38	9	47	0.00000
Actirhodobacter atriluteus	2744473	S	148	61	209	0.00001
Croceibacterium atlanticum	1267766	S	85	62	147	0.00000
Croceibacterium mercuriale	1572751	S	22	4	26	0.00000
Pelagerythrobacter aerophilus	2306995	S	61	41	102	0.00000
Pelagerythrobacter marinus	538382	S	17	17	34	0.00000
Pelagerythrobacter marensis	543877	S	17	3	20	0.00000
Tsuneonella suprasediminis	2306996	S	80	64	144	0.00000
Erythrobacteraceae bacterium	2026738	S	39	4	43	0.00000
Altericroceibacterium spongiae	2320269	S	35	21	56	0.00000
Parapontixanthobacter aurantiacus	1463599	S	24	20	44	0.00000
Pseudopontixanthobacter vadosimaris	2726450	S	24	14	38	0.00000
Novosphingopyxis iocasae	2762729	S	21597	11539	33136	0.00105
Novosphingopyxis baekryungensis	279369	S	3969	917	4886	0.00015
Citromicrobium sp.	2024827	S	2887	2345	5232	0.00017
Citromicrobium sp. UBA3494	1946345	S	171	283	454	0.00001
Citromicrobium sp. JLT1363	517722	S	25	38	63	0.00000
Citromicrobium bathyomarinum	72174	S	412	368	780	0.00002
Sphingomonas sp. SKA58	314266	S	2320	4467	6787	0.00022
Sphingomonas sp. Ant H11	1564113	S	102	403	505	0.00002
Sphingomonas sp.	28214	S	18	8	26	0.00000
Sphingomonas sp. FARSPH	2219696	S	17	9	26	0.00000
Sphingomonas abaci	237611	S	105	199	304	0.00001
Candidatus Sphingomonas excrementigallinarum	2838760	S	19	12	31	0.00000
Sphingomonas aquatilis	93063	S	14	60	74	0.00000
Sphingomonas paucimobilis	13689	S	12	23	35	0.00000
Sphingobium sp. CCH11-B1	1768781	S	556	1743	2299	0.00007
Sphingobium sp. C100	1207055	S	78	175	253	0.00001
Sphingobium sp. TCM1	453246	S	41	63	104	0.00000
Sphingobium sp.	1912891	S	24	13	37	0.00000
Sphingobium xenophagum	121428	S	661	1119	1780	0.00006
Sphingobium lactosutens	522773	S	76	313	389	0.00001
Sphingobium indicum	332055	S	65	99	164	0.00001
Sphingobium abikonense	86193	S	58	149	207	0.00001
Sphingobium yanoikuyae	13690	S	15	39	54	0.00000
Novosphingobium indicum	462949	S	450	484	934	0.00003
Novosphingobium marinum	1514948	S	94	73	167	0.00001
Novosphingobium sp. ST904	1684385	S	28	19	47	0.00000
Novosphingobium sp. PC22D	1962403	S	24	29	53	0.00000
Novosphingobium pentaromativorans	205844	S	34	34	68	0.00000
Novosphingobium malaysiense	1348853	S	29	9	38	0.00000
Novosphingobium silvae	2692619	S	19	50	69	0.00000
Novosphingobium panipatense	428991	S	16	25	41	0.00000
Novosphingobium aquimarinum	2682494	S	14	25	39	0.00000
Sphingopyxis sp.	1908224	S	894	748	1642	0.00005
Sphingopyxis macrogoltabida	33050	S	116	167	283	0.00001
Sphingopyxis indica	436663	S	59	41	100	0.00000
uncultured Parasphingopyxis sp.	1547918	S	559	1743	2302	0.00007
Sphingosinithalassobacter portus	2676234	S	374	148	522	0.00002
Sphingorhabdus sp. 109	2653173	S	296	188	484	0.00002
Rhizorhabdus histidinilytica	439228	S	72	65	137	0.00000
Rhizorhabdus sp.	1968843	S	56	148	204	0.00001
Stakelama pacifica	517720	S	90	103	193	0.00001
Sphingomonadaceae bacterium	1930536	S	22	9	31	0.00000
Sphingomonadaceae bacterium MED-G03	1986231	S	16	8	24	0.00000
Sphingomonadales bacterium	1978525	S	518	314	832	0.00003
Pacificimonas flava	1234595	S	101	81	182	0.00001
Rickettsiales bacterium	2026788	S	126996	63130	190126	0.00603
Rickettsiales bacterium TMED211	1986869	S	25	45	70	0.00000
uncultured Rickettsiaceae bacterium	194194	S	86	0	86	0.00000
uncultured Candidatus Midichloriaceae bacterium	1806454	S	16	1	17	0.00000
Rhodospirillaceae bacterium	1898112	S	97687	34178	131865	0.00418
Rhodospirillaceae bacterium UBA2165	1952852	S	90	2	92	0.00000
Rhodospirillaceae bacterium TMED167	1986863	S	57	74	131	0.00000
Rhodospirillaceae bacterium UBA6608	1952863	S	19	7	26	0.00000
Thalassospira sp. MCCC 1A01148	501834	S	1018	1503	2521	0.00008
Thalassospira sp.	1912094	S	152	347	499	0.00002
Thalassospira sp. MCCC 1A01428	1470575	S	53	40	93	0.00000
Thalassospira sp. MCCC 1A03138	1470576	S	21	125	146	0.00000
Thalassospira lucentensis	168935	S	370	863	1233	0.00004
Thalassospira profundimaris	502049	S	237	737	974	0.00003
Thalassospira xiamenensis	220697	S	65	344	409	0.00001
Thalassospira tepidiphila	393657	S	18	149	167	0.00001
Thalassospira xianhensis	478503	S	18	61	79	0.00000
Thalassospira povalilytica	732237	S	14	9	23	0.00000
Magnetovibrio sp.	2024836	S	88	22	110	0.00000
Rhodospirillales bacterium	2026786	S	2010	743	2753	0.00009
Tistrella mobilis	171437	S	695	210	905	0.00003
Nisaea sp.	2024842	S	108	20	128	0.00000
Oceanibaculum nanhaiense	1909734	S	45	75	120	0.00000
Thalassobaculum litoreum	420996	S	44	15	59	0.00000
Terasakiella pusilla	64973	S	12	2	14	0.00000
uncultured Rhodospirillales bacterium	296830	S	12	3	15	0.00000
Paracoccaceae bacterium	1904441	S	22954	8575	31529	0.00100
Paracoccus sp. UBA889	1947056	S	2931	2560	5491	0.00017
Paracoccus sp. R12_2	2821098	S	835	736	1571	0.00005
Paracoccus sp. MKU1	1745182	S	14	57	71	0.00000
Tritonibacter mobilis	379347	S	1889	1548	3437	0.00011
Tritonibacter scottomollicae	483013	S	600	269	869	0.00003
Tritonibacter horizontis	1768241	S	12	16	28	0.00000
Albimonas donghaensis	356660	S	1664	519	2183	0.00007
Albimonas pacifica	1114924	S	135	66	201	0.00001
Pacificitalea manganoxidans	1411902	S	1856	664	2520	0.00008
Marinibacterium profundimaris	1679460	S	1763	3375	5138	0.00016
Pseudooceanicola atlanticus	1461694	S	859	1428	2287	0.00007
Pseudooceanicola nanhaiensis	375761	S	210	280	490	0.00002
Pseudooceanicola lipolyticus	2029104	S	57	102	159	0.00001
Pseudooceanicola sp.	1914328	S	36	11	47	0.00000
Pseudooceanicola marinus	396013	S	34	14	48	0.00000
Allosediminivita pacifica	1267769	S	230	330	560	0.00002
Limimaricola cinnabarinus	1125964	S	131	81	212	0.00001
Rhodovulum sp.	34009	S	147	59	206	0.00001
Vannielia litorea	1217970	S	148	83	231	0.00001
Alterinioella nitratireducens	2735915	S	103	55	158	0.00001
Arenibacterium halophilum	2583821	S	72	21	93	0.00000
Thalassobium sp.	2030825	S	69	57	126	0.00000
Pseudophaeobacter arcticus	385492	S	33	33	66	0.00000
uncultured Pseudophaeobacter sp.	1759421	S	18	6	24	0.00000
Pararhodobacter zhoushanensis	2479545	S	20	12	32	0.00000
Pararhodobacter marinus	2184063	S	14	9	23	0.00000
Thioclava marina	1915077	S	17	26	43	0.00000
Pseudohalocynthiibacter aestuariivivens	1591409	S	14	0	14	0.00000
Pseudopuniceibacterium sediminis	2211117	S	13	9	22	0.00000
uncultured Rhodobacteraceae bacterium	157276	S	12	2	14	0.00000
Salipiger profundus	1229727	S	7812	9184	16996	0.00054
Salipiger bermudensis	344736	S	4283	5088	9371	0.00030
Salipiger thiooxidans	282683	S	176	284	460	0.00001
Salipiger marinus	555512	S	140	142	282	0.00001
Sulfitobacter sp. D7	1968541	S	587	2770	3357	0.00011
Sulfitobacter sp. R18_2	2821105	S	541	1580	2121	0.00007
Sulfitobacter sp.	1903071	S	368	800	1168	0.00004
Sulfitobacter sp. DFL-14	215828	S	30	54	84	0.00000
Sulfitobacter sp. HI0040	1822232	S	19	21	40	0.00000
Sulfitobacter sp. BDSS02	2663018	S	19	35	54	0.00000
Sulfitobacter pontiacus	60137	S	2967	4977	7944	0.00025
Sulfitobacter litoralis	335975	S	149	578	727	0.00002
Sulfitobacter dubius	218673	S	50	73	123	0.00000
Sulfitobacter delicatus	218672	S	39	79	118	0.00000
Sulfitobacter indolifex	225422	S	24	41	65	0.00000
Roseovarius indicus	540747	S	953	235	1188	0.00004
Roseovarius halotolerans	505353	S	936	1958	2894	0.00009
Roseovarius sp.	1486281	S	479	460	939	0.00003
Roseovarius sp. A-2	1570360	S	23	18	41	0.00000
Roseovarius mucosus	215743	S	457	1018	1475	0.00005
Roseovarius nitratireducens	2044597	S	142	153	295	0.00001
Roseovarius nubinhibens	314263	S	71	47	118	0.00000
Roseovarius tolerans	74031	S	59	37	96	0.00000
Roseovarius pacificus	337701	S	44	32	76	0.00000
Roseovarius lutimaris	1005928	S	19	10	29	0.00000
Roseovarius nanhaiticus	573024	S	12	6	18	0.00000
Roseovarius azorensis	1287727	S	12	12	24	0.00000
Roseobacter sp. MED193	314262	S	1121	1101	2222	0.00007
Roseobacter sp.	1907202	S	30	16	46	0.00000
Phaeobacter gallaeciensis	60890	S	854	297	1151	0.00004
Phaeobacter sp. CECT 5382	1712645	S	43	11	54	0.00000
Phaeobacter sp. 22II1-1F12B	1317111	S	19	33	52	0.00000
Tranquillimonas alkanivorans	441119	S	697	180	877	0.00003
Maritimibacter sp.	2003363	S	263	145	408	0.00001
Thalassobius sp.	1979401	S	152	80	232	0.00001
Jannaschia helgolandensis	188906	S	116	52	168	0.00001
Maribius pelagius	387096	S	27	89	116	0.00000
Sagittula sp. P11	2009329	S	48	27	75	0.00000
Roseivivax marinus	1379903	S	31	18	49	0.00000
Roseivivax sediminis	936889	S	20	9	29	0.00000
Actibacterium naphthalenivorans	1614693	S	54	94	148	0.00000
Thiosulfatihalobacter marinus	2792481	S	30	36	66	0.00000
Primorskyibacter flagellatus	1387277	S	20	24	44	0.00000
Palleronia rufa	1530186	S	15	11	26	0.00000
Marinovum sp.	2024839	S	17	7	24	0.00000
Leisingera caerulea	506591	S	18	6	24	0.00000
Tropicibacter alexandrii	2267683	S	18	21	39	0.00000
Pseudosulfitobacter pseudonitzschiae	1402135	S	16	15	31	0.00000
Loktanella ponticola	1524255	S	15	12	27	0.00000
Rhodobacterales bacterium 52_120_T64	1856301	S	15	0	15	0.00000
Hyphomonas adhaerens	81029	S	18385	8250	26635	0.00084
Hyphomonas sp.	87	S	6135	8526	14661	0.00046
Hyphomonas sp. L-53-1-40	1207058	S	1945	1397	3342	0.00011
Hyphomonas sp. CY54-11-8	1280944	S	930	1736	2666	0.00008
Hyphomonas sp. UBA5111	1946637	S	202	449	651	0.00002
Hyphomonas sp. BRH_c22	1629710	S	46	159	205	0.00001
Hyphomonas sp. 34-62-18	1970392	S	29	69	98	0.00000
Hyphomonas atlantica	1280948	S	2474	5533	8007	0.00025
Hyphomonas pacifica	1280941	S	690	3410	4100	0.00013
Hyphomonas oceanitis	81033	S	57	117	174	0.00001
Hyphomonas chukchiensis	1280947	S	54	153	207	0.00001
Hyphomonas beringensis	1280946	S	16	18	34	0.00000
Henriciella sp.	1968823	S	27967	21467	49434	0.00157
Henriciella aquimarina	545261	S	68	170	238	0.00001
Henriciella litoralis	568102	S	65	66	131	0.00000
Hirschia sp.	2024835	S	1701	405	2106	0.00007
Ponticaulis sp.	2020902	S	1269	588	1857	0.00006
Hyphomonadaceae bacterium TMED5	1986776	S	170	207	377	0.00001
Hyphomonadaceae bacterium BRH_c29	1629720	S	58	58	116	0.00000
Hyphomonadaceae bacterium UBA5336	1951953	S	20	21	41	0.00000
uncultured Alphaproteobacteria bacterium	91750	S	55543	44884	100427	0.00318
Rhodobiaceae bacterium	2026785	S	10628	6094	16722	0.00053
Rhodobiaceae bacterium UBA7804	1952834	S	464	486	950	0.00003
Martelella sp. AD-3	686597	S	3576	3859	7435	0.00024
Martelella mediterranea	293089	S	874	357	1231	0.00004
Martelella limonii	1647649	S	14	3	17	0.00000
Aurantimonas coralicida	182270	S	574	2305	2879	0.00009
Aurantimonas manganoxydans	651183	S	27	93	120	0.00000
Fulvimarina sp.	1969479	S	403	712	1115	0.00004
Fulvimarina manganoxydans	937218	S	336	38	374	0.00001
Jiella pacifica	2696469	S	77	69	146	0.00000
Stappia sp.	1870903	S	2415	2545	4960	0.00016
Stappia indica	538381	S	470	498	968	0.00003
Roseibium aggregatum	187304	S	1244	526	1770	0.00006
Methylobacterium fujisawaense	107400	S	219	327	546	0.00002
Hyphomicrobiales bacterium	1909294	S	417	167	584	0.00002
Hoeflea sp.	1940281	S	101	199	300	0.00001
Nitratireductor sp.	1872084	S	91	53	144	0.00000
Mesorhizobium sediminum	1849104	S	12	20	32	0.00000
Ahrensia sp.	1872419	S	310	367	677	0.00002
Pseudorhizobium pelagicum	1509405	S	85	39	124	0.00000
Endobacterium cereale	2663029	S	12	8	20	0.00000
Pelagibacterium sp.	1967288	S	81	67	148	0.00000
Devosia indica	2079253	S	18	10	28	0.00000
Devosia pacifica	1335967	S	12	5	17	0.00000
Parvibaculum sp.	2024848	S	83	60	143	0.00000
Bradyrhizobium sp. MOS002	2133947	S	16	32	48	0.00000
Beijerinckiaceae bacterium RH AL1	2572036	S	52	13	65	0.00000
Acuticoccus yangtzensis	1443441	S	28	3	31	0.00000
Acuticoccus sediminis	2184697	S	17	2	19	0.00000
Filomicrobium sp.	2024831	S	15	3	18	0.00000
Oceanicaulis sp. HTCC2633	314254	S	4774	4329	9103	0.00029
Oceanicaulis sp. PT13A	2135616	S	138	52	190	0.00001
Oceanicaulis alexandrii	153233	S	13	4	17	0.00000
Maricaulis maris	74318	S	1447	388	1835	0.00006
Maricaulis sp.	1486257	S	1273	538	1811	0.00006
Hellea sp.	2715692	S	492	137	629	0.00002
uncultured SAR116 cluster alpha proteobacterium	281031	S	1089	1484	2573	0.00008
SAR116 cluster bacterium	2024888	S	20	32	52	0.00000
SAR116 cluster bacterium AG-335-B03	2162575	S	12	165	177	0.00001
uncultured OCS116 cluster bacterium	648187	S	24	34	58	0.00000
Parvularcula sp.	1979207	S	297	283	580	0.00002
Marinicaulis flavus	2058213	S	13	2	15	0.00000
Caulobacteraceae bacterium UBA3198	1951537	S	112	53	165	0.00001
Kordiimonadales bacterium IMCC3096	1914870	S	51	7	58	0.00000
Kordiimonadaceae bacterium	2664180	S	15	3	18	0.00000
Sneathiella sp.	1964365	S	19	5	24	0.00000
Proteobacteria bacterium UBA1148	1948131	S	38107	10484	48591	0.00154
Pseudomonadota bacterium	1977087	S	15459	7411	22870	0.00072
Proteobacteria bacterium UBA2996	1948156	S	190	201	391	0.00001
Proteobacteria bacterium UBA7447	1948216	S	89	140	229	0.00001
Proteobacteria bacterium UBA2133	1948144	S	46	2	48	0.00000
Proteobacteria bacterium UBA6522	1948196	S	44	26	70	0.00000
Proteobacteria bacterium UBA1515	1948135	S	40	29	69	0.00000
Proteobacteria bacterium UBA6503	1948193	S	38	8	46	0.00000
Proteobacteria bacterium TMED61	1986601	S	21	52	73	0.00000
Pusillimonas maritima	2026239	S	318	617	935	0.00003
Pusillimonas sp. DMV24BSW_D	2716226	S	73	100	173	0.00001
Pusillimonas sp. (ex Stolz et al. 2005)	1979962	S	38	31	69	0.00000
Alcaligenes faecalis	511	S	13	12	25	0.00000
uncultured Burkholderiales bacterium	208544	S	446	189	635	0.00002
Ralstonia insidiosa	190721	S	33	63	96	0.00000
Ralstonia pickettii	329	S	12	36	48	0.00000
Paraburkholderia azotifigens	2057004	S	32	18	50	0.00000
Paraburkholderia sp. BL23I1N1	1938802	S	12	8	20	0.00000
Limnobacter alexandrii	2570352	S	26	9	35	0.00000
Massilia timonae	47229	S	34	78	112	0.00000
Curvibacter sp.	1888168	S	21	26	47	0.00000
Diaphorobacter aerolatus	1288495	S	14	32	46	0.00000
Nitrosomonadaceae bacterium	2026767	S	962	190	1152	0.00004
Methylobacillus sp.	56818	S	79	12	91	0.00000
uncultured Methylophilaceae bacterium	239732	S	68	20	88	0.00000
Nitrosomonadales bacterium	2026761	S	74	16	90	0.00000
Propionivibrio sp.	2212460	S	12	3	15	0.00000
Candidatus Lambdaproteobacteria bacterium	2035771	S	2528	387	2915	0.00009
uncultured proteobacterium	153809	S	42	11	53	0.00000
zeta proteobacterium SCGC AB-137-C09	1131284	S	17	11	28	0.00000
SAR324 cluster bacterium SAR324-CTD7B	1795556	S	562777	3172568	3735345	0.11837
uncultured SAR324 cluster bacterium	179114	S	292583	429167	721750	0.02287
SAR324 cluster bacterium REDSEA-S27_B3	1811637	S	16466	2336	18802	0.00060
SAR324 cluster bacterium	2024889	S	5597	406	6003	0.00019
SAR324 cluster bacterium JCVI-SC AAA005	1073573	S	166	128	294	0.00001
SAR324 cluster bacterium lautmerah10	1764262	S	141	79	220	0.00001
Deltaproteobacteria bacterium	2026735	S	200549	30671	231220	0.00733
Deltaproteobacteria bacterium UBA6930	1948562	S	43	5	48	0.00000
Deltaproteobacteria bacterium UBA6601	1948561	S	40	14	54	0.00000
SAR202 cluster bacterium	2030829	S	1284535	684016	1968551	0.06238
SAR202 cluster bacterium AC-647-N09_OGT_505m	2587833	S	16698	598	17296	0.00055
SAR202 cluster bacterium AC-647-P02_OGT_505m	2587832	S	15195	4508	19703	0.00062
SAR202 cluster bacterium AC-409-J13_OGT_754m	2587834	S	5745	74	5819	0.00018
SAR202 cluster bacterium AD-804-J14_MRT_500m	2587836	S	1187	4	1191	0.00004
SAR202 cluster bacterium Io17-Chloro-G6	1926615	S	186	4	190	0.00001
SAR202 cluster bacterium Io17-Chloro-G4	1926613	S	118	1	119	0.00000
Chloroflexota bacterium	2026724	S	710385	87160	797545	0.02527
Chloroflexi bacterium UBA6622	1947840	S	687	2617	3304	0.00010
Chloroflexi bacterium TSY	2834438	S	17	50	67	0.00000
Dehalococcoidia bacterium	2026734	S	338130	42329	380459	0.01206
Dehalococcoidia bacterium UBA6495	1948511	S	45291	50901	96192	0.00305
Dehalococcoidia bacterium UBA1122	1948466	S	42849	4509	47358	0.00150
Dehalococcoidia bacterium UBA7891	1948532	S	33064	22856	55920	0.00177
Dehalococcoidia bacterium UBA1123	1948467	S	11262	11192	22454	0.00071
Dehalococcoidia bacterium UBA2158	1948480	S	6772	4445	11217	0.00036
Dehalococcoidia bacterium UBA1141	1948469	S	5582	920	6502	0.00021
Dehalococcoidia bacterium UBA1151	1948470	S	3168	457	3625	0.00011
Dehalococcoidia bacterium UBA1152	1948471	S	766	430	1196	0.00004
Dehalococcoidia bacterium UBA1127	1948468	S	529	26	555	0.00002
Dehalococcoidia bacterium UBA7894	1948533	S	227	192	419	0.00001
Dehalococcoidia bacterium UBA1332	1948476	S	144	175	319	0.00001
Dehalococcoidia bacterium UBA2160	1948481	S	102	14	116	0.00000
Dehalococcoidia bacterium UBA6926	1948518	S	50	4	54	0.00000
Dehalococcoidia bacterium UBA6627	1948514	S	49	12	61	0.00000
Dehalococcoidia bacterium UBA6952	1948522	S	14	41	55	0.00000
uncultured Dehalococcoidales bacterium	2006128	S	437	56	493	0.00002
Dehalococcoidales bacterium	2026733	S	63	7	70	0.00000
Anaerolineales bacterium UBA1136	1950187	S	1629	312	1941	0.00006
Anaerolineales bacterium UBA832	1950226	S	1090	1323	2413	0.00008
Anaerolineales bacterium UBA3001	1950202	S	924	2510	3434	0.00011
Anaerolineales bacterium UBA3499	1950205	S	273	592	865	0.00003
Anaerolineaceae bacterium	2024896	S	6244	564	6808	0.00022
Acidimicrobiaceae bacterium	2024894	S	125394	43496	168890	0.00535
Candidatus Microthrix sp. UBA2110	1946164	S	62476	142949	205425	0.00651
Candidatus Microthrix sp. UBA4542	1946188	S	58961	42757	101718	0.00322
Candidatus Microthrix sp. UBA3125	1946176	S	390	649	1039	0.00003
Candidatus Microthrix sp. UBA672	1946197	S	310	275	585	0.00002
Candidatus Microthrix sp. UBA2131	1946167	S	113	168	281	0.00001
Candidatus Microthrix sp. UBA2974	1946174	S	91	9	100	0.00000
Candidatus Microthrix sp. UBA6944	1946199	S	55	35	90	0.00000
Candidatus Microthrix sp. UBA7388	1946207	S	39	1	40	0.00000
Candidatus Microthrix sp. UBA2983	1946175	S	27	16	43	0.00000
Acidimicrobiales bacterium	2201156	S	27550	11906	39456	0.00125
Acidimicrobiales bacterium AG-414-N20	2162616	S	214	131	345	0.00001
Ilumatobacteraceae bacterium	2497619	S	3140	2336	5476	0.00017
Acidimicrobiia bacterium	2080302	S	6899	2668	9567	0.00030
Microbacteriaceae bacterium UBA1487	1952239	S	10729	7359	18088	0.00057
Microbacterium sp. UBA1097	1946941	S	5175	7155	12330	0.00039
Microbacterium sp.	51671	S	392	208	600	0.00002
Microbacterium sp. 67-17	1895782	S	30	31	61	0.00000
Microbacterium sp. 5K110	2578104	S	20	18	38	0.00000
Microbacterium luteum	2782167	S	337	706	1043	0.00003
Microbacterium testaceum	2033	S	33	11	44	0.00000
Microbacterium profundi	450380	S	20	7	27	0.00000
Microbacterium schleiferi	69362	S	15	9	24	0.00000
Chryseoglobus indicus	2750620	S	131	124	255	0.00001
Marinisubtilis pacificus	2591847	S	70	72	142	0.00000
Microcella flavibacter	1804990	S	24	14	38	0.00000
uncultured Schumannella sp.	1195956	S	12	4	16	0.00000
Kocuria palustris	71999	S	167	166	333	0.00001
Kocuria polaris	136273	S	107	154	261	0.00001
Micrococcus endophyticus	455343	S	88	115	203	0.00001
Micrococcus luteus	1270	S	15	23	38	0.00000
Nesterenkonia halotolerans	225325	S	15	69	84	0.00000
Rothia dentocariosa	2047	S	21	42	63	0.00000
Neomicrococcus lactis	732241	S	73	19	92	0.00000
Glutamicibacter ardleyensis	225894	S	17	32	49	0.00000
Ornithinimicrobium sp. CNJ-824	1904966	S	353	170	523	0.00002
Serinicoccus chungangensis	767452	S	60	55	115	0.00000
Brevibacterium casei	33889	S	55	94	149	0.00000
Brevibacterium sp. W7.2	2823518	S	14	43	57	0.00000
Brachybacterium paraconglomeratum	173362	S	67	100	167	0.00001
Kytococcus sedentarius	1276	S	47	32	79	0.00000
Kytococcus aerolatus	592308	S	13	5	18	0.00000
Janibacter indicus	857417	S	21	17	38	0.00000
Dermacoccus nishinomiyaensis	1274	S	29	18	47	0.00000
Cutibacterium acnes	1747	S	2903	5072	7975	0.00025
Cutibacterium granulosum	33011	S	166	45	211	0.00001
Cutibacterium namnetense	1574624	S	51	12	63	0.00000
Nocardioides sp.	35761	S	954	469	1423	0.00005
Nocardioides sp. REDSEA-S33_B3	1811554	S	12	13	25	0.00000
Nocardioides salarius	374513	S	146	117	263	0.00001
Nocardioides marinus	374514	S	34	32	66	0.00000
Pimelobacter sp.	51662	S	111	202	313	0.00001
Mycolicibacterium poriferae	39694	S	397	1256	1653	0.00005
Mycolicibacterium hippocampi	659824	S	21	19	40	0.00000
Mycobacterium sp. PO1	1882219	S	67	207	274	0.00001
Corynebacterium tuberculostearicum	38304	S	71	201	272	0.00001
Corynebacterium gottingense	2041036	S	41	24	65	0.00000
Corynebacterium kefirresidentii	1979527	S	27	98	125	0.00000
Corynebacterium aurimucosum	169292	S	20	48	68	0.00000
Corynebacterium appendicis	163202	S	16	18	34	0.00000
Dietzia maris	37915	S	49	69	118	0.00000
Lawsonella clevelandensis	1528099	S	35	26	61	0.00000
Actinomycetia bacterium	1883427	S	710	280	990	0.00003
OCS155 cluster bacterium AG-333-G23	2162605	S	287	321	608	0.00002
actinobacterium SCGC AAA027-L06	913338	S	18	9	27	0.00000
marine actinobacterium MedAcidi-G1	1550399	S	14	4	18	0.00000
uncultured Candidatus Actinomarina sp.	1985113	S	1077	971	2048	0.00006
Streptomyces sp. SirexAA-E	862751	S	48	23	71	0.00000
Streptomyces sp. P3	2135430	S	36	19	55	0.00000
Streptomyces sp. rh34	2034272	S	18	14	32	0.00000
Streptomyces sp. SUK 48	2582831	S	16	15	31	0.00000
Actinomyces oris	544580	S	22	59	81	0.00000
Actinomyces sp. oral taxon 448	712124	S	16	6	22	0.00000
Pseudonocardia alni	33907	S	26	34	60	0.00000
Epidermidibacterium keratini	1891644	S	18	8	26	0.00000
Euzebya pacifica	1608957	S	42	20	62	0.00000
Prochlorococcus sp. AG-402-O21	2162099	S	46	610	656	0.00002
Prochlorococcus sp. AG-686-P16	2162219	S	15	404	419	0.00001
uncultured Prochlorococcus sp.	159733	S	53	13134	13187	0.00042
Prochlorococcus marinus	1219	S	24	2283	2307	0.00007
Cyanobium sp. ARS6	2024869	S	32	303	335	0.00001
Synechococcus sp. UW179A	2575510	S	15	117	132	0.00000
Aulosira sp. FACHB-615	2692777	S	85	53	138	0.00000
Anabaena sp. FACHB-1237	2692769	S	24	14	38	0.00000
Candidatus Margulisbacteria bacterium	2053573	S	82	6	88	0.00000
Candidatus Marinamargulisbacteria bacterium SCGC AG-343-D04	2184343	S	57	1	58	0.00000
Candidatus Saganbacteria bacterium	2575572	S	77	2	79	0.00000
Candidatus Melainabacteria bacterium	2052166	S	55	13	68	0.00000
Staphylococcus saccharolyticus	33028	S	2264	731	2995	0.00009
Staphylococcus epidermidis	1282	S	516	890	1406	0.00004
Staphylococcus hominis	1290	S	384	202	586	0.00002
Staphylococcus capitis	29388	S	381	173	554	0.00002
Staphylococcus warneri	1292	S	175	273	448	0.00001
Staphylococcus haemolyticus	1283	S	164	336	500	0.00002
Staphylococcus saprophyticus	29385	S	155	143	298	0.00001
Staphylococcus cohnii	29382	S	150	183	333	0.00001
Staphylococcus arlettae	29378	S	144	62	206	0.00001
Staphylococcus equorum	246432	S	88	76	164	0.00001
Staphylococcus aureus	1280	S	18	49	67	0.00000
Staphylococcus lugdunensis	28035	S	15	1	16	0.00000
Staphylococcus massiliensis	555791	S	13	2	15	0.00000
Staphylococcus auricularis	29379	S	13	2	15	0.00000
Staphylococcus sp. M0911	2025492	S	12	17	29	0.00000
Salinicoccus roseus	45670	S	2622	989	3611	0.00011
Salinicoccus luteus	367840	S	137	38	175	0.00001
Salinicoccus qingdaonensis	576118	S	34	18	52	0.00000
Salinicoccus cyprini	2493691	S	27	5	32	0.00000
Salinicoccus sediminis	1432562	S	15	9	24	0.00000
Abyssicoccus albus	1817405	S	209	75	284	0.00001
Jeotgalicoccus aerolatus	709510	S	98	30	128	0.00000
Jeotgalicoccus marinus	516700	S	42	8	50	0.00000
Macrococcus bohemicus	1903056	S	24	44	68	0.00000
Mammaliicoccus vitulinus	71237	S	19	8	27	0.00000
Mammaliicoccus sciuri	1296	S	13	2	15	0.00000
Planomicrobium okeanokoites	244	S	293	138	431	0.00001
Planococcus citreus	1373	S	52	140	192	0.00001
Bacillus subtilis	1423	S	20	102	122	0.00000
Brochothrix thermosphacta	2756	S	22	0	22	0.00000
Aerococcus viridans	1377	S	280	978	1258	0.00004
Aerococcus urinaeequi	51665	S	137	743	880	0.00003
Aerococcus sp. UBA6277	1945961	S	29	112	141	0.00000
Weissella cibaria	137591	S	70	11	81	0.00000
Lactiplantibacillus plantarum	1590	S	41	30	71	0.00000
Lactiplantibacillus pentosus	1589	S	15	12	27	0.00000
Paucilactobacillus vaccinostercus	176291	S	15	4	19	0.00000
Latilactobacillus curvatus	28038	S	14	13	27	0.00000
Streptococcus sanguinis	1305	S	14	132	146	0.00000
Alkalibacterium putridalgicola	426703	S	16	7	23	0.00000
Marinilactibacillus piezotolerans	258723	S	13	5	18	0.00000
Bacilli bacterium	1903720	S	44	36	80	0.00000
Oscillospiraceae bacterium	2485925	S	205	58	263	0.00001
Ruminococcus flavefaciens	1265	S	51	18	69	0.00000
uncultured Lachnospiraceae bacterium	297314	S	62	52	114	0.00000
Roseburia faecis	301302	S	13	82	95	0.00000
Lachnospiraceae bacterium	1898203	S	21	17	38	0.00000
Lachnoclostridium sp. UBA6558	1946697	S	13	12	25	0.00000
Syntrophomonadaceae bacterium	2093811	S	46	9	55	0.00000
Clostridiales bacterium	1898207	S	16	8	24	0.00000
Clostridia bacterium	2044939	S	13	3	16	0.00000
Peptoniphilus lacydonensis	1673725	S	33	36	69	0.00000
Finegoldia magna	1260	S	25	64	89	0.00000
Bacillota bacterium	1879010	S	27	7	34	0.00000
Trueperaceae bacterium	2026798	S	361	51	412	0.00001
Mycoplasmatales bacterium	2023991	S	210	21	231	0.00001
Mycoplasmataceae bacterium	2685873	S	91	15	106	0.00000
Candidatus Marinimicrobia bacterium	2026760	S	1771409	486597	2258006	0.07156
Candidatus Marinimicrobia bacterium UBA1611	1953216	S	165177	92120	257297	0.00815
Candidatus Marinimicrobia bacterium UBA7303	1953256	S	80343	42741	123084	0.00390
Candidatus Marinimicrobia bacterium UBA2125	1953217	S	5992	8220	14212	0.00045
Marinimicrobia bacterium SCGC AAA003-L08	939844	S	3182	35	3217	0.00010
Marinimicrobia bacterium TCS55	1781246	S	757	98	855	0.00003
uncultured Candidatus Marinimicrobia bacterium	195045	S	694	383	1077	0.00003
Candidatus Marinimicrobia bacterium UBA7301	1953255	S	675	117	792	0.00003
Candidatus Marinimicrobia bacterium UBA1134	1953213	S	568	143	711	0.00002
Candidatus Marinimicrobia bacterium UBA6531	1953244	S	566	357	923	0.00003
Candidatus Marinimicrobia bacterium UBA6931	1953249	S	529	37	566	0.00002
Candidatus Marinimicrobia bacterium UBA7308	1953257	S	445	31	476	0.00002
Candidatus Marinimicrobia bacterium UBA2986	1953231	S	195	12	207	0.00001
Candidatus Marinimicrobia bacterium UBA7300	1953254	S	194	101	295	0.00001
Candidatus Marinimicrobia bacterium 408169	1958814	S	145	20	165	0.00001
Candidatus Marinimicrobia bacterium REDSEA-S14_B6	1811603	S	140	25	165	0.00001
Candidatus Marinimicrobia bacterium UBA2980	1953230	S	128	27	155	0.00000
Gemmatimonadota bacterium	2026742	S	371647	109846	481493	0.01526
Gemmatimonadales bacterium UBA1120	1951099	S	28316	236041	264357	0.00838
Gemmatimonadales bacterium UBA7889	1951131	S	23139	106532	129671	0.00411
Gemmatimonadales bacterium UBA2988	1951110	S	4422	113	4535	0.00014
Gemmatimonadales bacterium UBA1142	1951102	S	959	481	1440	0.00005
Gemmatimonadales bacterium UBA2989	1951111	S	897	687	1584	0.00005
Gemmatimonadales bacterium UBA2982	1951109	S	587	8	595	0.00002
Gemmatimonadales bacterium UBA7835	1951129	S	15	23	38	0.00000
Gemmatimonadaceae bacterium	2026741	S	304	136	440	0.00001
Flavobacteriaceae bacterium	1871037	S	81290	34426	115716	0.00367
Flavobacteriaceae bacterium UBA3611	1951834	S	1816	755	2571	0.00008
Flavobacteriaceae bacterium UBA3356	1951828	S	652	654	1306	0.00004
Flavobacteriaceae bacterium UBA3179	1951824	S	52	108	160	0.00001
Flavobacteriaceae bacterium PRS1	2483459	S	24	7	31	0.00000
Mesonia oceanica	2687242	S	18717	6525	25242	0.00080
Mesonia mobilis	369791	S	2696	4554	7250	0.00023
Mesonia algae	213248	S	767	77	844	0.00003
Mesonia sp.	1960830	S	304	416	720	0.00002
Mesonia aquimarina	1504967	S	184	96	280	0.00001
Muricauda sp. MAR_2010_75	1250232	S	4628	2239	6867	0.00022
Muricauda sp.	192149	S	2589	1791	4380	0.00014
Muricauda sp. TMED12	1986608	S	221	219	440	0.00001
Muricauda sp. ARW1Y1	2663843	S	46	11	57	0.00000
Muricauda lutaonensis	516051	S	6197	1197	7394	0.00023
Muricauda ruestringensis	111501	S	2835	1866	4701	0.00015
Muricauda oceanensis	2499163	S	530	455	985	0.00003
Muricauda hadalis	2597517	S	266	187	453	0.00001
Muricauda brasiliensis	2162892	S	84	25	109	0.00000
Muricauda lutimaris	475082	S	54	35	89	0.00000
Muricauda aequoris	2306997	S	54	40	94	0.00000
Muricauda oceani	2698672	S	51	49	100	0.00000
Muricauda pacifica	1080225	S	31	2	33	0.00000
Muricauda sediminis	2696468	S	22	17	39	0.00000
Muricauda amoyensis	2169401	S	17	5	22	0.00000
Salegentibacter mishustinae	270918	S	6833	14831	21664	0.00069
Salegentibacter sp. R32	1486285	S	272	137	409	0.00001
Salegentibacter sp. Hel_I_6	1250278	S	156	230	386	0.00001
Salegentibacter sp. 24	2183986	S	38	41	79	0.00000
Salegentibacter sp.	1903072	S	16	7	23	0.00000
Salegentibacter agarivorans	345907	S	201	295	496	0.00002
Salegentibacter salarius	435906	S	98	145	243	0.00001
Salegentibacter salegens	143223	S	57	38	95	0.00000
Salegentibacter holothuriorum	241145	S	20	8	28	0.00000
Salegentibacter salinarum	447422	S	16	9	25	0.00000
Maribacter dokdonensis	320912	S	12598	4911	17509	0.00055
Maribacter litoralis	2059726	S	904	668	1572	0.00005
Maribacter sp.	1897614	S	124	24	148	0.00000
Maribacter sp. 4G9	1889777	S	84	64	148	0.00000
Maribacter cobaltidurans	1178778	S	127	116	243	0.00001
Maribacter hydrothermalis	1836467	S	28	4	32	0.00000
Maribacter caenipelagi	1447781	S	21	12	33	0.00000
Zunongwangia profunda	398743	S	16751	26634	43385	0.00137
Zunongwangia atlantica	1502297	S	132	65	197	0.00001
Zunongwangia sp. ESRF-bin46	2011156	S	63	99	162	0.00001
Zunongwangia mangrovi	1334022	S	33	10	43	0.00000
Leeuwenhoekiella blandensis	360293	S	7755	4105	11860	0.00038
Leeuwenhoekiella palythoae	573501	S	3094	946	4040	0.00013
Leeuwenhoekiella sp.	1977054	S	671	263	934	0.00003
Leeuwenhoekiella sp. MAR_2009_132	1392489	S	12	5	17	0.00000
Leeuwenhoekiella polynyae	1550906	S	544	1246	1790	0.00006
Leeuwenhoekiella aequorea	283736	S	257	178	435	0.00001
Leeuwenhoekiella nanhaiensis	1655491	S	104	77	181	0.00001
Leeuwenhoekiella marinoflava	988	S	86	76	162	0.00001
Gramella sp. Hel_I_59	1249978	S	4177	4597	8774	0.00028
Christiangramia portivictoriae	326069	S	906	1321	2227	0.00007
Christiangramia flava	1486245	S	343	343	686	0.00002
Christiangramia bathymodioli	2541727	S	169	161	330	0.00001
Christiangramia forsetii	411153	S	147	108	255	0.00001
Christiangramia fulva	2126553	S	54	26	80	0.00000
Christiangramia echinicola	279359	S	42	57	99	0.00000
Olleya sp. Hel_I_94	1250001	S	4205	4990	9195	0.00029
Olleya marilimosa	272164	S	699	781	1480	0.00005
Joostella marina	453852	S	8296	6233	14529	0.00046
Croceibacter atlanticus	313588	S	5292	819	6111	0.00019
Arenibacter algicola	616991	S	598	448	1046	0.00003
Arenibacter sp. P308M17	2303391	S	22	4	26	0.00000
Aequorivita sp.	1872390	S	658	399	1057	0.00003
Aequorivita sp. UBA3180	1947773	S	88	62	150	0.00000
Winogradskyella eximia	262006	S	256	143	399	0.00001
Winogradskyella sp.	1883156	S	118	39	157	0.00000
Winogradskyella psychrotolerans	1344585	S	12	7	19	0.00000
Nonlabens ulvanivorans	906888	S	331	203	534	0.00002
Nonlabens dokdonensis	328515	S	22	2	24	0.00000
Candidatus Ulvibacter alkanivorans	2267620	S	372	144	516	0.00002
uncultured Flavobacteriaceae bacterium	165436	S	332	122	454	0.00001
Aquimarina sp.	1872586	S	120	40	160	0.00001
Salinimicrobium nanhaiense	2722701	S	74	4	78	0.00000
Salinimicrobium marinum	680283	S	60	1	61	0.00000
Gillisia sp. CAL575	985255	S	73	5	78	0.00000
Gillisia mitskevichiae	270921	S	31	9	40	0.00000
Polaribacter vadi	1774273	S	27	32	59	0.00000
Polaribacter sp. MED152	313598	S	12	10	22	0.00000
Euzebyella marina	1761453	S	81	98	179	0.00001
Marixanthomonas ophiurae	387659	S	60	27	87	0.00000
Bizionia echini	649333	S	24	14	38	0.00000
Aquaticitalea lipolytica	1247562	S	31	10	41	0.00000
Tenacibaculum sp. SG-28	754426	S	18	0	18	0.00000
Kordia sp.	1965332	S	26	17	43	0.00000
Dokdonia pacifica	1627892	S	13	1	14	0.00000
Psychroserpens mesophilus	325473	S	12	3	15	0.00000
Altibacter lentus	1223410	S	15	6	21	0.00000
Flavobacteriales bacterium	2021391	S	17510	4455	21965	0.00070
Flavobacteriales bacterium UBA7878	1951087	S	2384	1547	3931	0.00012
Flavobacteriales bacterium UBA5081	1951031	S	913	148	1061	0.00003
Flavobacteriales bacterium UBA1112	1950946	S	237	13	250	0.00001
Flavobacteriales bacterium UBA6770	1951056	S	69	7	76	0.00000
Flavobacteriales bacterium TMED123	1986721	S	16	43	59	0.00000
Owenweeksia sp.	2024847	S	879	55	934	0.00003
Empedobacter brevis	247	S	175	172	347	0.00001
Empedobacter falsenii	343874	S	27	54	81	0.00000
Crocinitomicaceae bacterium	2026728	S	210	63	273	0.00001
Fluviicola sp.	1917219	S	47	7	54	0.00000
uncultured Flavobacteriales bacterium	213322	S	188	56	244	0.00001
Cryomorphaceae bacterium	1898111	S	114	63	177	0.00001
Acidiluteibacter ferrifornacis	2692424	S	49	9	58	0.00000
Cytophagaceae bacterium	2026729	S	6378	2270	8648	0.00027
Roseivirga thermotolerans	1758176	S	3543	132	3675	0.00012
Flammeovirgaceae bacterium UBA7330	1951792	S	2263	447	2710	0.00009
Flammeovirgaceae bacterium	2026740	S	14	2	16	0.00000
uncultured Marinoscillum sp.	932004	S	306	34	340	0.00001
Cyclobacterium marinum	104	S	28	12	40	0.00000
Cyclobacteriaceae bacterium	2099675	S	23	12	35	0.00000
Litoribacter ruber	702568	S	13	2	15	0.00000
Marivirga lumbricoides	1046115	S	47	20	67	0.00000
Bacteroidota bacterium	1898104	S	5703	907	6610	0.00021
uncultured Bacteroidetes bacterium	152509	S	2295	934	3229	0.00010
Bacteroidales bacterium	2030927	S	570	156	726	0.00002
Prevotella sp.	59823	S	22	33	55	0.00000
Prevotellaceae bacterium UBA7017	1952525	S	13	6	19	0.00000
Rikenellaceae bacterium	2049048	S	21	10	31	0.00000
uncultured Bacteroidales bacterium	194843	S	40	25	65	0.00000
Sphingobacterium siyangense	459529	S	189	143	332	0.00001
Sphingobacterium multivorum	28454	S	131	278	409	0.00001
uncultured Flavihumibacter sp.	1145287	S	58	18	76	0.00000
Chitinophagaceae bacterium	1869212	S	13	1	14	0.00000
Saprospiraceae bacterium	2202734	S	23	3	26	0.00000
Saprospiraceae bacterium UBA7328	1952882	S	14	0	14	0.00000
Rubrivirga sp. SAORIC476	1961794	S	17331	9930	27261	0.00086
Rubrivirga sp.	1885344	S	42	49	91	0.00000
Rubrivirga marina	1196024	S	65	29	94	0.00000
Rubricoccus marinus	716817	S	65	2	67	0.00000
Rhodothermaeota bacterium MED-G19	1986240	S	32	1	33	0.00000
Balneolaceae bacterium UBA7797	1951519	S	1066	100	1166	0.00004
Balneolaceae bacterium UBA3186	1951498	S	149	43	192	0.00001
Balneolaceae bacterium	2053516	S	36	2	38	0.00000
Balneola sp.	2024824	S	81	33	114	0.00000
Ignavibacteriales bacterium	2049428	S	13	0	13	0.00000
Candidatus Latescibacteria bacterium	2053570	S	8135	1208	9343	0.00030
Latescibacteria bacterium UBA6620	1948115	S	1816	20	1836	0.00006
Candidatus Hydrogenedentes bacterium	2030809	S	87	8	95	0.00000
Planctomycetota bacterium	2026780	S	278033	42078	320111	0.01014
Planctomycetes bacterium UBA1662	1948126	S	17615	48047	65662	0.00208
Planctomycetes bacterium UBA1135	1948124	S	3522	1260	4782	0.00015
Planctomycetes bacterium UBA1146	1948125	S	21	19	40	0.00000
Planctomycetes bacterium UBA7888	1948130	S	12	0	12	0.00000
Planctomycetaceae bacterium	2026779	S	133018	11871	144889	0.00459
Planctomycetaceae bacterium UBA2972	1952733	S	44	1	45	0.00000
Planctomycetaceae bacterium TMED10	1986833	S	13	2	15	0.00000
Rubinisphaera brasiliensis	119	S	828	10	838	0.00003
Gimesia chilikensis	2605989	S	25	140	165	0.00001
Gimesia benthica	2608982	S	15	97	112	0.00000
Fuerstiella sp.	1936112	S	253	6	259	0.00001
Planctomyces sp.	37635	S	28	1	29	0.00000
Planctomycetales bacterium ZRK34	2723666	S	12	0	12	0.00000
Rhodopirellula sp.	2024855	S	543	177	720	0.00002
Mariniblastus sp.	2005381	S	345	21	366	0.00001
Pirellulaceae bacterium	2699754	S	27	1	28	0.00000
Pirellulales bacterium	2715253	S	177	7	184	0.00001
Planctomycetia bacterium TMED53	1986839	S	14	13	27	0.00000
Phycisphaerae bacterium	2026778	S	10207	1762	11969	0.00038
Phycisphaerales bacterium	2052180	S	1175	112	1287	0.00004
Phycisphaerales bacterium UBA3190	1951198	S	940	65	1005	0.00003
Phycisphaerales bacterium UBA1910	1951186	S	824	110	934	0.00003
Phycisphaerales bacterium UBA7812	1951207	S	415	86	501	0.00002
Phycisphaerales bacterium UBA854	1951209	S	37	51	88	0.00000
Phycisphaeraceae bacterium	2026777	S	1698	189	1887	0.00006
Candidatus Scalindua rubra	1872076	S	25	0	25	0.00000
Candidatus Scalindua sp.	2268189	S	15	1	16	0.00000
Verrucomicrobiota bacterium	2026799	S	152421	78311	230732	0.00731
Verrucomicrobia bacterium UBA673	1948281	S	1893	16430	18323	0.00058
Verrucomicrobia bacterium Opi.OSU.00C	2067063	S	1535	35	1570	0.00005
Verrucomicrobia bacterium UBA6775	1948282	S	171	1071	1242	0.00004
Verrucomicrobia bacterium SCGC AAA164-E04	1009415	S	12	24	36	0.00000
Verrucomicrobiales bacterium	2026801	S	66059	43122	109181	0.00346
Roseibacillus sp.	2024856	S	5800	9795	15595	0.00049
Verrucomicrobiaceae bacterium	2026800	S	101	31	132	0.00000
Akkermansiaceae bacterium UBA7890	1951374	S	743	1884	2627	0.00008
Akkermansiaceae bacterium UBA1506	1951351	S	61	71	132	0.00000
Verrucomicrobia subdivision 3 bacterium	2052186	S	176	50	226	0.00001
Pedosphaera sp.	2024890	S	17	7	24	0.00000
Verrucomicrobiae bacterium	2499141	S	249	162	411	0.00001
Opitutae bacterium UBA1116	1948703	S	2827	75	2902	0.00009
Opitutae bacterium	2026771	S	1897	1973	3870	0.00012
Opitutae bacterium UBA3151	1948718	S	448	271	719	0.00002
Opitutae bacterium UBA7876	1948743	S	69	3	72	0.00000
Candidatus Moanabacter tarae	2200854	S	1445	10	1455	0.00005
Puniceicoccaceae bacterium	2026784	S	120	160	280	0.00001
Coraliomargarita sp.	2024828	S	15	0	15	0.00000
Opitutales bacterium UBA2995	1951177	S	188	12	200	0.00001
Opitutales bacterium	2026772	S	39	25	64	0.00000
uncultured Opitutales bacterium	592834	S	120	82	202	0.00001
Opitutaceae bacterium	2006848	S	99	31	130	0.00000
uncultured Verrucomicrobiota bacterium	156588	S	793	360	1153	0.00004
Lentisphaera araneosa	256847	S	271	3	274	0.00001
Chlamydiia bacterium	2052156	S	60	1	61	0.00000
Waddliaceae bacterium	2026802	S	19	2	21	0.00000
uncultured Chlamydiae bacterium	305355	S	18	0	18	0.00000
Candidatus Omnitrophota bacterium	2035772	S	25	2	27	0.00000
Kiritimatiellia bacterium	2212473	S	12	11	23	0.00000
Acidobacteriota bacterium	1978231	S	472449	57435	529884	0.01679
Acidobacteria bacterium UBA2999	1953107	S	5187	855	6042	0.00019
Acidobacteria bacterium UBA2990	1953105	S	2036	1858	3894	0.00012
Acidobacteria bacterium UBA823	1953113	S	1313	690	2003	0.00006
Acidobacteria bacterium UBA2994	1953106	S	187	565	752	0.00002
Acidobacteria bacterium UBA2161	1953103	S	53	43	96	0.00000
Acidobacteriia bacterium UBA6623	1948748	S	999	373	1372	0.00004
Kocuria sp. cx-455	2771377	S	22	32	54	0.00000
Candidatus Poribacteria bacterium	2026781	S	348503	20860	369363	0.01171
Candidatus Uhrbacteria bacterium	2053634	S	16231	1574	17805	0.00056
Parcubacteria group bacterium	2026774	S	1191	163	1354	0.00004
Candidatus Magasanikbacteria bacterium	2026717	S	69	2	71	0.00000
Candidatus Falkowbacteria bacterium	2053554	S	18	1	19	0.00000
Patescibacteria group bacterium UBA3527	1948812	S	115	1	116	0.00000
Patescibacteria group bacterium	2052139	S	31	2	33	0.00000
Patescibacteria group bacterium UBA2135	1948793	S	15	0	15	0.00000
Patescibacteria group bacterium UBA3466	1948809	S	13	0	13	0.00000
Candidatus Woesebacteria bacterium	2026804	S	29	0	29	0.00000
Candidatus Dadabacteria bacterium UBA1144	1953208	S	1352	193	1545	0.00005
Candidatus Saccharibacteria bacterium	2026720	S	81	10	91	0.00000
Candidatus Saccharibacteria bacterium GW2011_GWC2_48_9	1619071	S	14	0	14	0.00000
Candidatus Peregrinibacteria bacterium	2030811	S	16	0	16	0.00000
Candidatus Binatota bacterium	2528255	S	13	18	31	0.00000
Candidatus Nitromaritima sp. SCGC AAA288-L16	913337	S	123232	38081	161313	0.00511
Nitrospina sp.	2024844	S	61083	23928	85011	0.00269
Nitrospina sp. LS_NOB	1671875	S	137	55	192	0.00001
Nitrospinaceae bacterium	2358456	S	961	265	1226	0.00004
Nitrospinaceae bacterium UBA7883	1953054	S	62	3	65	0.00000
uncultured Nitrospinaceae bacterium	407034	S	636	479	1115	0.00004
Nitrospinota bacterium	2026769	S	185	33	218	0.00001
uncultured Nitrospinota bacterium	2448460	S	20	2	22	0.00000
Micavibrio sp.	2024841	S	12155	3283	15438	0.00049
Micavibrio sp. UBA2137	1946913	S	817	250	1067	0.00003
Micavibrio sp. TMED2	1986633	S	728	1044	1772	0.00006
Micavibrio sp. UBA2638	1946917	S	666	322	988	0.00003
Micavibrio sp. TMED27	1986607	S	93	119	212	0.00001
Micavibrio sp. UBA1850	1946909	S	25	5	30	0.00000
Micavibrio sp. UBA2705	1946918	S	22	0	22	0.00000
Micavibrio sp. UBA5572	1946924	S	13	2	15	0.00000
Pseudobdellovibrionaceae bacterium	2026715	S	225	6	231	0.00001
Bdellovibrionaceae bacterium UBA3535	1961513	S	14	0	14	0.00000
Bdellovibrio sp.	28201	S	18	3	21	0.00000
Halobacteriovoraceae bacterium	2026745	S	1550	64	1614	0.00005
Halobacteriovorax sp.	2020862	S	30	4	34	0.00000
Bacteriovoracaceae bacterium	2081706	S	510	4	514	0.00002
Bacteriovoracaceae bacterium UBA7317	1961497	S	15	0	15	0.00000
Oligoflexia bacterium	2599941	S	81	4	85	0.00000
Myxococcales bacterium	2026763	S	8365	628	8993	0.00028
Myxococcales bacterium UBA1660	1961462	S	3255	526	3781	0.00012
Sandaracinus sp.	2024858	S	1704	229	1933	0.00006
Polyangiaceae bacterium	2268199	S	21	0	21	0.00000
Nitrospirales bacterium	2358460	S	2893	119	3012	0.00010
Nitrospiraceae bacterium UBA2166	1952976	S	2520	1773	4293	0.00014
Nitrospiraceae bacterium	2026770	S	222	9	231	0.00001
Nitrospira sp.	70125	S	32	4	36	0.00000
Nitrospirota bacterium	2026887	S	14	1	15	0.00000
Sulfurimonas sp.	2022749	S	3806	671	4477	0.00014
Sulfurospirillum sp.	2053622	S	12	1	13	0.00000
Spirochaetaceae bacterium	1898206	S	2253	161	2414	0.00008
Spirochaetaceae bacterium bin103	1919263	S	23	0	23	0.00000
Spirochaetales bacterium	2026792	S	349	24	373	0.00001
Leptospirales bacterium	2604146	S	192	2	194	0.00001
Leptospira gomenensis	2484974	S	28	0	28	0.00000
Spirochaetia bacterium	2053615	S	14	3	17	0.00000
bacterium	1869227	S	2372	4181	6553	0.00021
bacterium TMED46	1986782	S	21	51	72	0.00000
bacterium TMED88	1986661	S	19	2	21	0.00000
Desulforhopalus singaporensis	91360	S	52	2	54	0.00000
Candidatus Desulfobacula maris	2841694	S	16	18	34	0.00000
Fusobacteriia bacterium UBA1095	1948575	S	94	2	96	0.00000
uncultured bacterium	77133	S	56	171	227	0.00001
uncultured PS1 clade bacterium	1118065	S	52	139	191	0.00001
Marine Group I thaumarchaeote	2511932	S	515088	3080161	3595249	0.11393
Thaumarchaeota archaeon SCGC AAA007-O23	913333	S	157010	1646817	1803827	0.05716
uncultured marine group I thaumarchaeote	360837	S	9968	25280	35248	0.00112
Marine Group I thaumarchaeote SCGC AAA799-O18	1502294	S	3648	2140	5788	0.00018
Candidatus Nitrosopelagicus sp.	2026808	S	68009	410308	478317	0.01516
Candidatus Nitrosopelagicus brevis	1410606	S	94	340	434	0.00001
Nitrososphaerota archaeon	2026795	S	264471	404276	668747	0.02119
Thaumarchaeota archaeon UBA141	1915753	S	174	825	999	0.00003
Thaumarchaeota archaeon SCGC AAA282-K18	1298885	S	12	195	207	0.00001
uncultured Candidatus Nitrosopumilus sp.	517606	S	404	1743	2147	0.00007
Nitrosopumilus sp.	2024843	S	62	133	195	0.00001
Nitrososphaerales archaeon TH5895	2721602	S	58	1	59	0.00000
Candidatus Methanosuratincola sp.	2495426	S	9087	5818	14905	0.00047
Candidatus Bathyarchaeota archaeon	2026714	S	132	25	157	0.00000
Euryarchaeota archaeon UBA528	1915914	S	347398	250435	597833	0.01895
Candidatus Poseidoniales archaeon	2163009	S	4893	2594	7487	0.00024
Euryarchaeota archaeon UBA623	1915969	S	4128	1269	5397	0.00017
Marine Group II euryarchaeote MED-G34	2007295	S	1923	812	2735	0.00009
Euryarchaeota archaeon UBA54	1915920	S	1271	1756	3027	0.00010
Euryarchaeota archaeon UBA58	1915943	S	257	111	368	0.00001
Euryarchaeota archaeon UBA60	1915951	S	134	2	136	0.00000
Euryarchaeota archaeon UBA53	1915916	S	87	7	94	0.00000
Euryarchaeota archaeon UBA557	1915935	S	27	5	32	0.00000
Euryarchaeota archaeon UBA538	1915919	S	19	3	22	0.00000
Marine Group II euryarchaeote MED-G36	2007297	S	19	8	27	0.00000
Euryarchaeota archaeon UBA175	1915821	S	18	19	37	0.00000
Euryarchaeota archaeon UBA86	1915978	S	17	14	31	0.00000
Marine Group II euryarchaeote MED-G33	2007294	S	16	1	17	0.00000
Candidatus Thalassoarchaea betae	2599289	S	2588	1579	4167	0.00013
Candidatus Thalassarchaeaceae archaeon	2670411	S	455	331	786	0.00002
Candidatus Poseidoniaceae archaeon	2666346	S	410	318	728	0.00002
uncultured Candidatus Poseidoniales archaeon	274854	S	37	24	61	0.00000
Euryarchaeota archaeon UBA136	1915770	S	97758	236905	334663	0.01061
Marine Group III euryarchaeote CG-Bathy1	1889001	S	1760	498	2258	0.00007
Euryarchaeota archaeon UBA102	1915769	S	368	165	533	0.00002
uncultured marine group III euryarchaeote	360836	S	76	9	85	0.00000
Euryarchaeota archaeon UBA488	1915775	S	55	106	161	0.00001
Euryarchaeota archaeon	2026739	S	66083	31726	97809	0.00310
Euryarchaeota archaeon UBA24	1915765	S	62	3	65	0.00000
Marine Group IV archaeon HikBin4	2675329	S	3039	175	3214	0.00010
Candidatus Pacearchaeota archaeon	2026773	S	2244	228	2472	0.00008
Nanoarchaeota archaeon	2026764	S	109	10	119	0.00000
Candidatus Woesearchaeota archaeon	2026803	S	96	6	102	0.00000
Candidatus Diapherotrites archaeon	2026736	S	34	3	37	0.00000
archaeon	1906665	S	283	46	329	0.00001
Candidatus Heimdallarchaeota archaeon	2026747	S	18	1	19	0.00000
