name	taxonomy_id	taxonomy_lvl	kraken_assigned_reads	added_reads	new_est_reads	fraction_total_reads
Alteromonas macleodii	28108	S	256412	99921	356333	0.36732
Alteromonas mediterranea	314275	S	37962	18323	56285	0.05802
Alteromonas sp. B31-7	2785913	S	253	3102	3355	0.00346
Alteromonas sp. RKMC-009	2267264	S	236	18	254	0.00026
Alteromonas sp. RW2A1	1917158	S	193	323	516	0.00053
Alteromonas sp. MB-3u-76	2058133	S	44	49	93	0.00010
Alteromonas sp. BL110	1714845	S	23	5	28	0.00003
Alteromonas australica	589873	S	801	4172	4973	0.00513
Alteromonas naphthalenivorans	715451	S	42	44	86	0.00009
Salinimonas sediminis	2303538	S	71	15	86	0.00009
Salinimonas iocasae	2572577	S	53	14	67	0.00007
Gayadomonas joobiniege	1234606	S	13	0	13	0.00001
Pseudoalteromonas sp. SCSIO 43088	2822846	S	2316	3590	5906	0.00609
Pseudoalteromonas sp. APM04	2699396	S	112	1423	1535	0.00158
Pseudoalteromonas sp. SCSIO 43101	2822847	S	102	93	195	0.00020
Pseudoalteromonas sp. CF6-2	562716	S	79	555	634	0.00065
Pseudoalteromonas sp. JSTW	2752475	S	34	1104	1138	0.00117
Pseudoalteromonas sp. SM9913	234831	S	31	996	1027	0.00106
Pseudoalteromonas sp. MT33b	2759705	S	28	837	865	0.00089
Pseudoalteromonas sp. GCY	2003316	S	19	50	69	0.00007
Pseudoalteromonas sp. SCSIO 43095	2894202	S	18	75	93	0.00010
Pseudoalteromonas donghaensis	621376	S	750	19844	20594	0.02123
Pseudoalteromonas shioyasakiensis	1190813	S	657	884	1541	0.00159
Pseudoalteromonas rhizosphaerae	2518973	S	42	20	62	0.00006
Pseudoalteromonas phenolica	161398	S	36	4	40	0.00004
Pseudoalteromonas issachenkonii	152297	S	36	738	774	0.00080
Pseudoalteromonas lipolytica	570156	S	35	853	888	0.00092
Pseudoalteromonas tetraodonis	43659	S	31	918	949	0.00098
Pseudoalteromonas marina	267375	S	28	264	292	0.00030
Pseudoalteromonas agarivorans	176102	S	27	161	188	0.00019
Pseudoalteromonas nigrifaciens	28109	S	26	293	319	0.00033
Pseudoalteromonas arabiensis	874454	S	17	283	300	0.00031
Idiomarina loihiensis	135577	S	191	118	309	0.00032
Idiomarina sp. X4	2055892	S	46	206	252	0.00026
Idiomarina sp. OT37-5b	2100422	S	32	26	58	0.00006
Idiomarina piscisalsi	1096243	S	28	118	146	0.00015
Idiomarina abyssalis	86102	S	21	12	33	0.00003
Shewanella putrefaciens	24	S	17	53	70	0.00007
Colwellia sp. M166	2583805	S	68	14	82	0.00008
Halomonas meridiana	29570	S	54372	42826	97198	0.10020
Halomonas piezotolerans	2609667	S	559	303	862	0.00089
Halomonas sp. 18071143	2855441	S	191	417	608	0.00063
Halomonas sp. KO116	1504981	S	99	48	147	0.00015
Halomonas hydrothermalis	115561	S	73	255	328	0.00034
Chromohalobacter salexigens	158080	S	53	3	56	0.00006
Alcanivorax sp. ALC70	2259335	S	88	93	181	0.00019
Alcanivorax sp. N3-2A	2014542	S	14	17	31	0.00003
Alcanivorax borkumensis	59754	S	71	306	377	0.00039
Ketobacter alkanivorans	1917421	S	105	3	108	0.00011
Thalassolituus oleivorans	187493	S	80	32	112	0.00012
Marinobacterium georgiense	48076	S	78	31	109	0.00011
Venatorbacter cucullus	2661630	S	77	28	105	0.00011
Marinobacter nauticus	2743	S	7265	1305	8570	0.00883
Marinobacter salarius	1420917	S	6323	2300	8623	0.00889
Marinobacter sp. CP1	1671721	S	784	3046	3830	0.00395
Marinobacter sp. AN1	2886046	S	401	96	497	0.00051
Marinobacter sp. LQ44	1749259	S	134	173	307	0.00032
Marinobacter sp. Arc7-DN-1	2304594	S	96	13	109	0.00011
Marinobacter sp. NP-4(2019)	2488665	S	15	5	20	0.00002
Marinobacter salsuginis	418719	S	123	40	163	0.00017
Marinobacter adhaerens	1033846	S	64	271	335	0.00035
Marinobacter similis	1420916	S	16	3	19	0.00002
Pseudomonas fluorescens	294	S	63	210	273	0.00028
Pseudomonas aeruginosa	287	S	17	410	427	0.00044
Halopseudomonas aestusnigri	857252	S	115	521	636	0.00066
Halopseudomonas sp. RR6	2918528	S	28	9	37	0.00004
Halopseudomonas sabulinigri	472181	S	32	4	36	0.00004
Kangiella geojedonensis	914150	S	3781	174	3955	0.00408
Psychrobacter sp. P11G5	1699624	S	30	200	230	0.00024
Psychrobacter sp. KCTC 72983	2733866	S	19	172	191	0.00020
Psychrobacter sp. AntiMn-1	1720344	S	12	187	199	0.00021
Acinetobacter venetianus	52133	S	27	112	139	0.00014
Francisella sp. FSC1006	1547445	S	381	100	481	0.00050
Methylophaga nitratireducenticrescens	754476	S	136	43	179	0.00018
Methylophaga pinxianii	2881052	S	85	56	141	0.00015
Marinagarivorans cellulosilyticus	2721545	S	36	23	59	0.00006
Marinimicrobium sp. C6131	3022676	S	32	7	39	0.00004
Teredinibacter haidensis	2731755	S	13	8	21	0.00002
Spongiibacter nanhainus	2794344	S	44	7	51	0.00005
Spongiibacter sp. IMCC21906	1620392	S	24	7	31	0.00003
Zhongshania aliphaticivorans	1470434	S	44	3	47	0.00005
Congregibacter litoralis	393662	S	26	18	44	0.00005
Vibrio tubiashii	29498	S	35	62	97	0.00010
Legionella spiritensis	452	S	18	8	26	0.00003
Erythrobacter sp. A30-3	2785907	S	105628	56288	161916	0.16691
Erythrobacter sp. THAF29	2587851	S	150	29	179	0.00018
Erythrobacter sp. 3-20A1M	2653850	S	75	43	118	0.00012
Erythrobacter litoralis	39960	S	1216	650	1866	0.00192
Erythrobacter aureus	2182384	S	49	6	55	0.00006
Erythrobacter mangrovi	2739433	S	21	8	29	0.00003
Porphyrobacter sp. CACIAM 03H1	2003315	S	16	5	21	0.00002
Qipengyuania flava	192812	S	8307	4617	12924	0.01332
Qipengyuania sp. PHS-Z21	2909673	S	334	189	523	0.00054
Qipengyuania sp. SS22	2979461	S	45	9	54	0.00006
Qipengyuania seohaensis	266951	S	54	19	73	0.00008
Qipengyuania gelatinilytica	2867231	S	30	10	40	0.00004
Qipengyuania aurantiaca	2867233	S	28	11	39	0.00004
Croceicoccus sp. Ery15	1703338	S	847	1132	1979	0.00204
Croceicoccus sp. Ery5	1703340	S	260	159	419	0.00043
Croceicoccus sp. YJ47	2798724	S	61	42	103	0.00011
Croceicoccus marinus	450378	S	747	455	1202	0.00124
Croceicoccus naphthovorans	1348774	S	216	457	673	0.00069
Aurantiacibacter atlanticus	1648404	S	402	141	543	0.00056
Tsuneonella flava	2055955	S	228	50	278	0.00029
Croceibacterium atlanticum	1267766	S	147	46	193	0.00020
Citromicrobium sp. JL477	1634516	S	10216	4179	14395	0.01484
Sphingobium xenophagum	121428	S	1361	3535	4896	0.00505
Sphingobium yanoikuyae	13690	S	655	3366	4021	0.00415
Sphingobium sp. YG1	2082188	S	189	363	552	0.00057
Sphingobium sp. TKS	1315974	S	21	132	153	0.00016
Sphingobium sp. RSMS	520734	S	15	314	329	0.00034
Sphingobium sp. PAMC28499	2565554	S	15	72	87	0.00009
Sphingobium sp. KCTC 72723	2733867	S	15	4	19	0.00002
Sphingobium sp. AntQ-1	2930091	S	13	14	27	0.00003
Sphingobium sp. RAC03	1843368	S	12	5	17	0.00002
Sphingobium fuliginis	336203	S	57	895	952	0.00098
Sphingobium cloacae	120107	S	21	177	198	0.00020
Sphingobium baderi	1332080	S	14	269	283	0.00029
Sphingobium phenoxybenzoativorans	1592790	S	12	33	45	0.00005
Sphingopyxis sp. FD7	1914525	S	451	463	914	0.00094
Sphingopyxis sp. DBS4	2968500	S	87	181	268	0.00028
Sphingopyxis sp. 113P3	292913	S	46	77	123	0.00013
Sphingopyxis alaskensis	117207	S	124	86	210	0.00022
Sphingopyxis terrae	33052	S	86	1130	1216	0.00125
Sphingopyxis macrogoltabida	33050	S	79	138	217	0.00022
Sphingopyxis granuli	267128	S	16	204	220	0.00023
Sphingomonas sp. FARSPH	2219696	S	154	174	328	0.00034
Sphingomonas sp. MM-1	745310	S	43	205	248	0.00026
Sphingomonas sp. LK11	1390395	S	36	34	70	0.00007
Sphingomonas sp. IC081	304378	S	35	391	426	0.00044
Sphingomonas sp. J315	2898433	S	12	6	18	0.00002
Sphingomonas melonis	152682	S	299	1052	1351	0.00139
Sphingomonas paucimobilis	13689	S	137	181	318	0.00033
Sphingomonas sanxanigenens	397260	S	53	122	175	0.00018
Sphingomonas koreensis	93064	S	29	56	85	0.00009
Sphingomonas naphthae	1813468	S	26	22	48	0.00005
Novosphingopyxis iocasae	2762729	S	360	193	553	0.00057
Sphingosinithalassobacter tenebrarum	2711215	S	292	92	384	0.00040
Novosphingobium sp. KA1	164608	S	37	327	364	0.00038
Novosphingobium sp. PP1Y	702113	S	31	18	49	0.00005
Novosphingobium pentaromativorans	205844	S	46	89	135	0.00014
Novosphingobium decolorationis	2698673	S	22	30	52	0.00005
Sulfitobacter sp. CB2047	1525218	S	412	24776	25188	0.02596
Sulfitobacter sp. SK025	1389011	S	245	8432	8677	0.00894
Sulfitobacter sp. W027	2867025	S	28	121	149	0.00015
Sulfitobacter pontiacus	60137	S	308	12141	12449	0.01283
Sulfitobacter alexandrii	1917485	S	126	1238	1364	0.00141
Sulfitobacter indolifex	225422	S	120	494	614	0.00063
Sulfitobacter faviae	1775881	S	100	514	614	0.00063
Sulfitobacter dubius	218673	S	15	170	185	0.00019
Roseovarius indicus	540747	S	471	2089	2560	0.00264
Pseudosulfitobacter pseudonitzschiae	1402135	S	151	638	789	0.00081
Pseudosulfitobacter sp. DSM 107133	2883100	S	137	534	671	0.00069
Phaeobacter inhibens	221822	S	150	301	451	0.00046
Phaeobacter gallaeciensis	60890	S	28	105	133	0.00014
Phaeobacter porticola	1844006	S	19	17	36	0.00004
Mameliella alba	561184	S	117	197	314	0.00032
Salipiger profundus	1229727	S	70	319	389	0.00040
Actibacterium sp. EMB200-NS6	1609966	S	62	428	490	0.00051
Celeribacter baekdonensis	875171	S	17	26	43	0.00004
Sagittula sp. P11	2009329	S	25	205	230	0.00024
Yangia pacifica	311180	S	24	17	41	0.00004
Octadecabacter sp. SW4	2602067	S	17	39	56	0.00006
Dinoroseobacter shibae	215813	S	16	79	95	0.00010
Pseudooceanicola atlanticus	1461694	S	4454	2319	6773	0.00698
Pacificitalea manganoxidans	1411902	S	1028	2250	3278	0.00338
Paracoccus sp. SCSIO 75817	3017781	S	29	154	183	0.00019
Paracoccus sp. Arc7-R13	2500532	S	27	68	95	0.00010
Paracoccus sp. SCSIO 75233	3017782	S	22	155	177	0.00018
Paracoccus sp. SCSIO 80058	3017784	S	13	15	28	0.00003
Paracoccus marcusii	59779	S	38	62	100	0.00010
Paracoccus alcaliphilus	34002	S	13	28	41	0.00004
Paracoccus stylophorae	659350	S	12	19	31	0.00003
Tritonibacter mobilis	379347	S	73	318	391	0.00040
Agrobacterium salinitolerans	1183413	S	613	1935	2548	0.00263
Agrobacterium tumefaciens	358	S	16	78	94	0.00010
Rhizobium sp. SSM4.3	2919917	S	77	43	120	0.00012
Rhizobium pusense	648995	S	26	329	355	0.00037
Shinella zoogloeoides	352475	S	32	149	181	0.00019
Shinella sp. HZN7	879274	S	14	39	53	0.00005
Roseibium aggregatum	187304	S	1711	1381	3092	0.00319
Roseibium sp. Sym1	3016006	S	62	58	120	0.00012
Devosia sp. I507	2083786	S	213	151	364	0.00038
Devosia salina	2860336	S	71	57	128	0.00013
Aquibium oceanicum	1670800	S	331	221	552	0.00057
Hoeflea sp. IMCC20628	1620421	S	17	4	21	0.00002
Martelella sp. AD-3	686597	S	69	203	272	0.00028
Martelella mediterranea	293089	S	22	52	74	0.00008
Jiella sp. HL-NP1	2986949	S	15	3	18	0.00002
Bosea sp. NBC_00436	2969620	S	16	19	35	0.00004
Bosea sp. RAC05	1842539	S	14	16	30	0.00003
Afipia sp. NBIMC_P1-C1	1320552	S	41	239	280	0.00029
Acuticoccus sp. I52.16.1	2928472	S	13	2	15	0.00002
Hyphomonas sp. KY3	2016196	S	1520	1451	2971	0.00306
Hyphomonas atlantica	1280948	S	1198	1364	2562	0.00264
Hirschia baltica	2724	S	21	0	21	0.00002
Brevundimonas sp. Bb-A	2560058	S	16	329	345	0.00036
Caulobacter flavus	1679497	S	16	29	45	0.00005
Candidatus Pelagibacter sp. FZCC0015	2268451	S	50	112	162	0.00017
Candidatus Pelagibacter sp. RS40	1977865	S	32	24	56	0.00006
Candidatus Pelagibacter sp. RS39	1977864	S	21	40	61	0.00006
Thalassospira sp. B30-1	2785911	S	19	90	109	0.00011
Thalassospira sp. GO-4	2946605	S	16	2	18	0.00002
Indioceanicola profundi	2220096	S	14	3	17	0.00002
Glycocaulis alkaliphilus	1434191	S	35	4	39	0.00004
Marinicauda algicola	2029849	S	13	14	27	0.00003
Parvularcula bermudensis	208216	S	14	19	33	0.00003
Cupriavidus pauculus	82633	S	62	49	111	0.00011
Hydrogenophaga crocea	2716225	S	37	49	86	0.00009
Pusillimonas sp. DMV24BSW_D	2716226	S	34	2	36	0.00004
Leeuwenhoekiella palythoae	573501	S	890	6065	6955	0.00717
Leeuwenhoekiella sp. ZYFB001	2719912	S	499	3219	3718	0.00383
Muricauda aquimarina	254955	S	5390	2611	8001	0.00825
Muricauda oceani	2698672	S	1499	536	2035	0.00210
Mesoflavibacter sp. SCSIO 43206	2779362	S	70	137	207	0.00021
Mesoflavibacter profundi	2708110	S	172	6035	6207	0.00640
Croceibacter atlanticus	313588	S	5701	518	6219	0.00641
Robiginitalea biformata	252307	S	1633	34	1667	0.00172
Maribacter cobaltidurans	1178778	S	113	70	183	0.00019
Maribacter dokdonensis	320912	S	67	943	1010	0.00104
Maribacter sp. 1_2014MBL_MicDiv	1644130	S	31	449	480	0.00049
Euzebyella marina	1761453	S	1507	451	1958	0.00202
Nonlabens spongiae	331648	S	112	428	540	0.00056
Nonlabens dokdonensis	328515	S	35	130	165	0.00017
Nonlabens ponticola	2496866	S	12	25	37	0.00004
Zunongwangia profunda	398743	S	246	146	392	0.00040
Zunongwangia sp. SCSIO 43204	2779359	S	113	66	179	0.00018
Salegentibacter mishustinae	270918	S	229	197	426	0.00044
Salegentibacter sp. T436	1729720	S	38	36	74	0.00008
Winogradskyella schleiferi	2686078	S	38	28	66	0.00007
Winogradskyella sp. MH6	2929510	S	20	18	38	0.00004
Winogradskyella forsetii	2686077	S	27	12	39	0.00004
Gilvibacter sp. SZ-19	754429	S	109	8	117	0.00012
Dokdonia sp. MED134	313590	S	14	84	98	0.00010
Flavobacterium sp. CS20	2775246	S	13	32	45	0.00005
Gramella flava	1486245	S	27	6	33	0.00003
Gramella sp. GC03-9	2920386	S	15	5	20	0.00002
Gillisia sp. Hel1_33_143	1336796	S	26	4	30	0.00003
Oceanihabitans sp. IOP_32	2529032	S	18	5	23	0.00002
Arenibacter algicola	616991	S	17	5	22	0.00002
Costertonia aggregata	343403	S	12	1	13	0.00001
Antarcticibacterium flavum	2058175	S	12	2	14	0.00001
Psychroserpens sp. MSW6	2932268	S	12	1	13	0.00001
Croceimicrobium hydrocarbonivorans	2761580	S	21	7	28	0.00003
Algoriphagus sp. NBT04N3	2705473	S	682	75	757	0.00078
Cyclobacterium marinum	104	S	138	39	177	0.00018
Marivirga tractuosa	1006	S	13	0	13	0.00001
Mycolicibacterium poriferae	39694	S	4045	5740	9785	0.01009
Mycolicibacterium mageritense	53462	S	20	19	39	0.00004
Mycobacterium frederiksbergense	117567	S	16	34	50	0.00005
Rhodococcus fascians	1828	S	32	58	90	0.00009
Nocardioides marinisabuli	419476	S	334	2102	2436	0.00251
Nocardioides sp. CF8	110319	S	26	149	175	0.00018
Nocardioides sp. S5	2017486	S	24	164	188	0.00019
Nocardioides piscis	2714938	S	86	349	435	0.00045
Nocardioides dokdonensis	450734	S	70	348	418	0.00043
Nocardioides rotundus	1774216	S	65	319	384	0.00040
Nocardioides coralli	2872154	S	61	169	230	0.00024
Nocardioides humi	449461	S	28	138	166	0.00017
Cutibacterium acnes	1747	S	121	200	321	0.00033
Microbacterium schleiferi	69362	S	554	3098	3652	0.00376
Microbacterium luteum	2782167	S	98	388	486	0.00050
Microbacterium sp. No. 7	1714373	S	19	74	93	0.00010
Chryseoglobus indicus	2750620	S	102	754	856	0.00088
Chryseoglobus sp. 28M-23	2772253	S	23	117	140	0.00014
Brevibacterium casei	33889	S	23	149	172	0.00018
Paenarthrobacter ureafaciens	37931	S	15	52	67	0.00007
Pseudonocardia sp. AL041005-10	445576	S	12	81	93	0.00010
Euzebya pacifica	1608957	S	126	112	238	0.00025
Prochlorococcus marinus	1219	S	1794	2618	4412	0.00455
Prochlorococcus sp. MIT 0801	1501269	S	14	1152	1166	0.00120
Parasynechococcus marenigrum	2881428	S	16	29	45	0.00005
Staphylococcus epidermidis	1282	S	21	29	50	0.00005
Staphylococcus hominis	1290	S	20	19	39	0.00004
Halobacteriovorax sp. BALOs_7	2109558	S	9304	83	9387	0.00968
Gimesia chilikensis	2605989	S	355	519	874	0.00090
Bremerella volcania	2527984	S	139	5	144	0.00015
Botrimarina mediterranea	2528022	S	114	2	116	0.00012
Candidatus Nitrosopelagicus brevis	1410606	S	503	587	1090	0.00112
Homo sapiens	9606	S	692	249	941	0.00097
Chosvirus KM23C739	2733898	S	15	0	15	0.00002
