name	taxonomy_id	taxonomy_lvl	kraken_assigned_reads	added_reads	new_est_reads	fraction_total_reads
Alteromonas australica	589873	S	796336	281849	1078185	0.07797
Alteromonas macleodii	28108	S	62965	86549	149514	0.01081
Alteromonas mediterranea	314275	S	8056	8295	16351	0.00118
Alteromonas sp. RKMC-009	2267264	S	4222	753	4975	0.00036
Alteromonas sp. IB21	2779369	S	2460	1771	4231	0.00031
Alteromonas sp. ALT199	1298865	S	267	197	464	0.00003
Alteromonas sp. BL110	1714845	S	235	216	451	0.00003
Alteromonas sp. KUL42	2480797	S	100	10	110	0.00001
Alteromonas sp. KUL106	2480799	S	96	27	123	0.00001
Alteromonas sp. 38	2653129	S	72	49	121	0.00001
Alteromonas sp. V450	1912139	S	49	24	73	0.00001
Alteromonas sp. KC3	2795688	S	39	7	46	0.00000
Alteromonas sp. KUL49	2480798	S	23	1	24	0.00000
Alteromonas sp. MMG017	2822692	S	14	9	23	0.00000
Alteromonas alba	2079529	S	6368	35818	42186	0.00305
Alteromonas antoniana	2803813	S	3054	2362	5416	0.00039
Alteromonas abrolhosensis	1892904	S	2968	2727	5695	0.00041
Alteromonas oceanisediminis	2836180	S	2760	520	3280	0.00024
Alteromonas marina	203795	S	2405	3044	5449	0.00039
Alteromonas oceani	2071609	S	1858	5478	7336	0.00053
Alteromonas profundi	2696062	S	1844	1026	2870	0.00021
Alteromonas portus	2565549	S	1016	726	1742	0.00013
Alteromonas genovensis	471225	S	312	173	485	0.00004
Alteromonas naphthalenivorans	715451	S	123	153	276	0.00002
Alteromonas gracilis	1479524	S	114	56	170	0.00001
Alteromonas lipolytica	1856405	S	23	2	25	0.00000
Alteromonas confluentis	1656094	S	23	2	25	0.00000
Alteromonas halophila	516698	S	17	3	20	0.00000
Alteromonas hispanica	315421	S	12	1	13	0.00000
Salinimonas sediminis	2303538	S	197	164	361	0.00003
Salinimonas chungwhensis	265425	S	84	11	95	0.00001
Salinimonas iocasae	2572577	S	37	8	45	0.00000
Salinimonas profundi	2729140	S	25	13	38	0.00000
Salinimonas lutimaris	914153	S	13	2	15	0.00000
Alteromonadaceae bacterium UBA2620	1951386	S	43410	117667	161077	0.01165
Alteromonadaceae bacterium	1916082	S	1444	550	1994	0.00014
Alteromonadaceae bacterium 2753L.S.0a.02	1403320	S	12	0	12	0.00000
Marisediminitalea aggregata	634436	S	277	32	309	0.00002
Glaciecola sp. UBA1851	1946570	S	55	6	61	0.00000
Glaciecola sp. XM2	1914931	S	47	1	48	0.00000
Glaciecola sp. HTCC2999	455436	S	25	2	27	0.00000
Aliiglaciecola lipolytica	477689	S	126	6	132	0.00001
Bowmanella denitrificans	366582	S	59	1	60	0.00000
Aestuariibacter sp.	1872400	S	15	2	17	0.00000
Neptunicella marina	2125989	S	31	4	35	0.00000
Ningiella ruwaisensis	2364274	S	14	4	18	0.00000
Hydrocarboniclastica marina	2259620	S	13	2	15	0.00000
Pseudoalteromonas shioyasakiensis	1190813	S	5641	47954	53595	0.00388
Pseudoalteromonas sp. MEBiC 03607	2563601	S	272	719	991	0.00007
Pseudoalteromonas sp. XI10	1766621	S	269	2963	3232	0.00023
Pseudoalteromonas sp. 0303	2743618	S	241	2634	2875	0.00021
Pseudoalteromonas sp. NBT06-2	2025950	S	168	11	179	0.00001
Pseudoalteromonas sp.	53249	S	128	564	692	0.00005
Pseudoalteromonas sp. HM-SA03	2029678	S	124	614	738	0.00005
Pseudoalteromonas sp. T1lg23B	2077097	S	48	30	78	0.00001
Pseudoalteromonas sp. '520P1 No. 423'	1690037	S	22	4	26	0.00000
Pseudoalteromonas gelatinilytica	1703256	S	236	1193	1429	0.00010
Pseudoalteromonas lipolytica	570156	S	209	614	823	0.00006
Pseudoalteromonas arabiensis	874454	S	75	69	144	0.00001
Pseudoalteromonas ruthenica	151081	S	56	12	68	0.00000
Pseudoalteromonas atlantica	288	S	30	64	94	0.00001
Pseudoalteromonas rhizosphaerae	2518973	S	28	110	138	0.00001
Pseudoalteromonas piscicida	43662	S	22	82	104	0.00001
Pseudoalteromonas marina	267375	S	13	21	34	0.00000
Idiomarina loihiensis	135577	S	983	465	1448	0.00010
Idiomarina baltica	190892	S	720	677	1397	0.00010
Idiomarina abyssalis	86102	S	174	87	261	0.00002
Idiomarina aquatica	1327752	S	162	57	219	0.00002
Idiomarina zobellii	86103	S	112	160	272	0.00002
Idiomarina seosinensis	281739	S	50	13	63	0.00000
Idiomarina xiamenensis	1207041	S	36	3	39	0.00000
Idiomarina piscisalsi	1096243	S	25	26	51	0.00000
Idiomarinaceae bacterium	1898113	S	174	124	298	0.00002
Pseudidiomarina aquimaris	641841	S	34	17	51	0.00000
Litorilituus sediminis	718192	S	905	112	1017	0.00007
Colwellia sp. RSH04	2305464	S	16	53	69	0.00000
Shewanella sp. 10N.286.51.B7	1880836	S	17	18	35	0.00000
Acidiferrobacteraceae bacterium	2024893	S	516482	276049	792531	0.05731
Gammaproteobacteria bacterium	1913989	S	377657	82263	459920	0.03326
Gammaproteobacteria bacterium UBA6940	1948640	S	32265	4523	36788	0.00266
Gammaproteobacteria bacterium REDSEA-S15_B12	1811666	S	10089	6730	16819	0.00122
gamma proteobacterium SCGC AAA007-O20	913327	S	5102	2836	7938	0.00057
gamma proteobacterium SCGC AB-629-P17	1131274	S	2408	2966	5374	0.00039
Gammaproteobacteria bacterium UBA3532	1948611	S	640	356	996	0.00007
Gammaproteobacteria bacterium UBA1119	1948582	S	456	388	844	0.00006
Gammaproteobacteria bacterium UBA7310	1948647	S	220	65	285	0.00002
Gammaproteobacteria bacterium UBA1961	1948588	S	62	12	74	0.00001
Gammaproteobacteria bacterium UBA7803	1948658	S	50	52	102	0.00001
gamma proteobacterium HdN1	83406	S	26	11	37	0.00000
Gammaproteobacteria bacterium UBA2955	1948602	S	26	2	28	0.00000
Gammaproteobacteria bacterium UBA3498	1948609	S	20	3	23	0.00000
Marinobacter nauticus	2743	S	29131	15249	44380	0.00321
Marinobacter segnicrescens	430453	S	12143	5089	17232	0.00125
Marinobacter sp.	50741	S	2112	1493	3605	0.00026
Marinobacter sp. B9-2	2137198	S	726	2372	3098	0.00022
Marinobacter sp. LQ44	1749259	S	372	827	1199	0.00009
Marinobacter sp. Arc7-DN-1	2304594	S	70	60	130	0.00001
Marinobacter sp. es.042	1761794	S	58	152	210	0.00002
Marinobacter sp. AC-23	1879031	S	49	8	57	0.00000
Marinobacter sp. F3R08	2841559	S	44	13	57	0.00000
Marinobacter sp. EhC06	1849169	S	36	60	96	0.00001
Marinobacter sp. es.048	1761795	S	20	10	30	0.00000
Marinobacter sp. BW6	2592624	S	19	14	33	0.00000
Marinobacter manganoxydans	1150997	S	1926	26226	28152	0.00204
Marinobacter fuscus	2109942	S	1631	1831	3462	0.00025
Marinobacter vinifirmus	355591	S	1214	1513	2727	0.00020
Marinobacter flavimaris	262076	S	552	7741	8293	0.00060
Marinobacter salsuginis	418719	S	431	405	836	0.00006
Marinobacter adhaerens	1033846	S	322	2285	2607	0.00019
Marinobacter aromaticivorans	1494078	S	220	59	279	0.00002
Marinobacter persicus	930118	S	213	163	376	0.00003
Marinobacter shengliensis	1389223	S	209	280	489	0.00004
Marinobacter salarius	1420917	S	147	242	389	0.00003
Marinobacter lipolyticus	209639	S	123	74	197	0.00001
Marinobacter oulmenensis	643747	S	97	12	109	0.00001
Marinobacter litoralis	187981	S	81	14	95	0.00001
Marinobacter profundi	2666256	S	55	30	85	0.00001
Marinobacter algicola	236100	S	43	42	85	0.00001
Marinobacter lutaoensis	135739	S	29	7	36	0.00000
Marinobacter santoriniensis	523742	S	28	3	31	0.00000
Marinobacter pelagius	379482	S	19	9	28	0.00000
Marinobacter maroccanus	2055143	S	14	15	29	0.00000
Marinobacter excellens	218670	S	13	14	27	0.00000
Halopseudomonas pachastrellae	254161	S	13301	19534	32835	0.00237
Halopseudomonas aestusnigri	857252	S	11043	10857	21900	0.00158
Halopseudomonas gallaeciensis	857227	S	4981	5139	10120	0.00073
Halopseudomonas oceani	1708783	S	949	915	1864	0.00013
Halopseudomonas sabulinigri	472181	S	471	104	575	0.00004
Halopseudomonas yangmingensis	1720063	S	58	34	92	0.00001
Halopseudomonas pelagia	553151	S	42	27	69	0.00000
Halopseudomonas formosensis	1002526	S	26	19	45	0.00000
Pseudomonas khazarica	2502979	S	1398	1497	2895	0.00021
Pseudomonas sp. SSM44	2487347	S	157	144	301	0.00002
Pseudomonas sp. SST3	2267882	S	43	100	143	0.00001
Pseudomonas sp.	306	S	20	97	117	0.00001
Pseudomonas saliphila	2586906	S	121	53	174	0.00001
Pseudomonas tohonis	2725477	S	88	149	237	0.00002
Pseudomonas chengduensis	489632	S	67	1066	1133	0.00008
Pseudomonas mendocina	300	S	32	92	124	0.00001
Pseudomonas profundi	1981513	S	41	36	77	0.00001
Pseudomonas bharatica	2692112	S	31	81	112	0.00001
Pseudomonas benzenivorans	556533	S	24	33	57	0.00000
Stutzerimonas stutzeri	316	S	2344	5848	8192	0.00059
Stutzerimonas kunmingensis	1211807	S	124	2483	2607	0.00019
Stutzerimonas chloritidismutans	203192	S	32	890	922	0.00007
Stutzerimonas xanthomarina	271420	S	24	524	548	0.00004
Pseudomonadaceae bacterium UBA836	1952795	S	419	477	896	0.00006
Pseudomonadaceae bacterium SI-3	2079806	S	231	375	606	0.00004
Gammaproteobacteria bacterium UBA2168	1948591	S	285	11	296	0.00002
Pseudomonadales bacterium	1891229	S	275	57	332	0.00002
Oceanospirillaceae bacterium	1899355	S	56365	12513	68878	0.00498
Neptuniibacter sp. UBA6509	1946976	S	20815	3326	24141	0.00175
Thalassolituus sp. UBA2107	1947659	S	4971	10806	15777	0.00114
Thalassolituus sp. UBA674	1947666	S	4811	1370	6181	0.00045
Thalassolituus sp. UBA1087	1947651	S	748	75	823	0.00006
Thalassolituus sp. C2-1	2597518	S	34	11	45	0.00000
Oleibacter marinus	484498	S	1740	2465	4205	0.00030
Oleibacter sp.	2024845	S	148	47	195	0.00001
Marinobacterium litorale	404770	S	251	65	316	0.00002
Marinobacterium iners	48076	S	21	2	23	0.00000
Marinomonas profundimaris	1208321	S	48	34	82	0.00001
Bacterioplanes sanyensis	1249553	S	17	0	17	0.00000
Halomonas zincidurans	1178777	S	2678	1387	4065	0.00029
Halomonas taeanensis	284577	S	2575	1049	3624	0.00026
Halomonas litopenaei	2109328	S	1596	1376	2972	0.00021
Halomonas piezotolerans	2609667	S	1585	1856	3441	0.00025
Halomonas aquamarina	77097	S	1363	5768	7131	0.00052
Halomonas sp.	1486246	S	386	200	586	0.00004
Halomonas sp. A40-4	2785909	S	186	211	397	0.00003
Halomonas sp. UBA3074	1946584	S	25	34	59	0.00000
Halomonas sp. 54_146	1635257	S	16	14	30	0.00000
Halomonas sp. EAR18	2518972	S	12	4	16	0.00000
Halomonas meridiana	29570	S	572	851	1423	0.00010
Halomonas lionensis	1144478	S	175	592	767	0.00006
Halomonas salina	42565	S	98	167	265	0.00002
Halomonas salicampi	1449798	S	58	20	78	0.00001
Halomonas sedimenti	2729618	S	22	40	62	0.00000
Halomonas hamiltonii	502829	S	20	62	82	0.00001
Halomonas sulfidaeris	115553	S	14	4	18	0.00000
Halomonas xianhensis	442341	S	14	5	19	0.00000
Halomonas stevensii	502821	S	13	52	65	0.00000
Cobetia amphilecti	1055104	S	5723	4138	9861	0.00071
Cobetia crustatorum	553385	S	242	181	423	0.00003
Cobetia marina	28258	S	65	42	107	0.00001
Salinicola salarius	430457	S	1441	1062	2503	0.00018
Salinicola sp.	1978524	S	85	175	260	0.00002
Salinicola peritrichatus	1267424	S	19	10	29	0.00000
Chromohalobacter israelensis	141390	S	200	227	427	0.00003
Alloalcanivorax profundimaris	2735259	S	7017	8281	15298	0.00111
Alloalcanivorax venustensis	172371	S	964	3168	4132	0.00030
Alloalcanivorax marinus	1177169	S	421	284	705	0.00005
Alloalcanivorax gelatiniphagus	1194167	S	119	99	218	0.00002
Alloalcanivorax dieselolei	285091	S	116	104	220	0.00002
Alcanivorax sp.	1872427	S	189	147	336	0.00002
Alcanivorax sp. UBA4485	1945988	S	140	169	309	0.00002
Alcanivorax sp. DSM 26293	1798238	S	126	158	284	0.00002
Alcanivorax sp. 24	2545266	S	21	20	41	0.00000
Alcanivorax hongdengensis	519051	S	88	42	130	0.00001
Alcanivoracaceae bacterium	2024895	S	148	186	334	0.00002
Ketobacter sp.	2083498	S	57	10	67	0.00000
Ketobacter sp. MCCC 1A13808	2602738	S	40	10	50	0.00000
Isoalcanivorax pacificus	1306787	S	23	19	42	0.00000
Endozoicomonas sp. G2_2	2821092	S	138	100	238	0.00002
Hahellaceae bacterium	2048971	S	55	4	59	0.00000
Oleiphilus sp.	2025907	S	51	3	54	0.00000
Acinetobacter venetianus	52133	S	6743	5498	12241	0.00089
Acinetobacter junii	40215	S	101	294	395	0.00003
Acinetobacter ihumii	2483802	S	61	91	152	0.00001
Acinetobacter baumannii	470	S	12	20	32	0.00000
Psychrobacter submarinus	154108	S	246	233	479	0.00003
Rheinheimera aquimaris	412437	S	5183	1404	6587	0.00048
Allochromatium humboldtianum	504901	S	20	6	26	0.00000
Chromatiales bacterium	2026725	S	2664	185	2849	0.00021
Woeseiaceae bacterium	2026806	S	1690	784	2474	0.00018
uncultured Woeseiaceae bacterium	1983305	S	20	1	21	0.00000
Ectothiorhodospiraceae bacterium	2026737	S	54	4	58	0.00000
Halothiobacillaceae bacterium UBA5861	1951926	S	34	3	37	0.00000
uncultured SAR86 cluster bacterium	648174	S	2346	762	3108	0.00022
SAR86 cluster bacterium REDSEA-S09_B4	1811643	S	540	27	567	0.00004
SAR86 cluster bacterium SAR86A	1123866	S	22	30	52	0.00000
SAR86 cluster bacterium AG-422-P06	2162555	S	19	3	22	0.00000
Candidatus Thioglobus sp. MED-G25	1986229	S	1953	621	2574	0.00019
Candidatus Thioglobus sp.	2026721	S	91	56	147	0.00001
Candidatus Thioglobus perditus	2058498	S	167	15	182	0.00001
uncultured Candidatus Thioglobus sp.	655186	S	80	76	156	0.00001
Candidatus Thioglobus autotrophicus	1705394	S	27	5	32	0.00000
marine gamma proteobacterium HTCC2089	247632	S	27	0	27	0.00000
K189A clade bacterium	2315472	S	21	7	28	0.00000
uncultured OM182 clade bacterium	1128416	S	16	1	17	0.00000
Candidatus Pseudothioglobus aerophilus	2841689	S	18	28	46	0.00000
Salinisphaera sp. UBA6602	1947455	S	620	336	956	0.00007
Salinisphaera sp. UBA1666	1947454	S	84	30	114	0.00001
Salinisphaera sp.	1914330	S	83	33	116	0.00001
Salinisphaera orenii	856731	S	348	1232	1580	0.00011
Salinisphaera shabanensis	180542	S	254	91	345	0.00002
Salinisphaera japonica	1304270	S	156	97	253	0.00002
Salinisphaera halophila	1304158	S	113	410	523	0.00004
Salinisphaera hydrothermalis	563188	S	80	10	90	0.00001
Salinisphaeraceae bacterium	2026789	S	22	0	22	0.00000
Spongiibacter tropicus	454602	S	1034	572	1606	0.00012
Spongiibacter marinus	354246	S	64	34	98	0.00001
Spongiibacter sp. IMCC21906	1620392	S	33	12	45	0.00000
Zhongshania aliphaticivorans	1470434	S	103	14	117	0.00001
Halioglobus sp.	2024834	S	180	46	226	0.00002
Halioglobus pacificus	930806	S	169	11	180	0.00001
Halioglobus japonicus	930805	S	16	0	16	0.00000
Haliea sp.	1932666	S	97	6	103	0.00001
Halieaceae bacterium	2026743	S	44	6	50	0.00000
Halieaceae bacterium UBA5085	1951918	S	36	19	55	0.00000
Porticoccaceae bacterium UBA1117	1952748	S	79	5	84	0.00001
Porticoccaceae bacterium	2026782	S	77	25	102	0.00001
SAR92 bacterium BACL16 MAG-120619-bin48	1655625	S	21	11	32	0.00000
Porticoccus hydrocarbonoclasticus	1073414	S	77	133	210	0.00002
Porticoccus sp.	2024853	S	33	27	60	0.00000
Gilvimarinus agarilyticus	679259	S	17	2	19	0.00000
Cellvibrio mixtus	39650	S	12	0	12	0.00000
Cellvibrionales bacterium UBA2511	1950788	S	14	29	43	0.00000
uncultured Gammaproteobacteria bacterium	86473	S	2416	395	2811	0.00020
Methylococcales bacterium OPU3_GD_OMZ	1920888	S	1350	150	1500	0.00011
Methylococcaceae bacterium UBA1147	1952219	S	192	22	214	0.00002
Methylophaga sp.	2024840	S	272	156	428	0.00003
Cycloclasticus sp.	2024830	S	146	35	181	0.00001
Hydrogenovibrio thermophilus	265883	S	22	15	37	0.00000
uncultured Francisellaceae bacterium	393692	S	173	1	174	0.00001
Thiotrichales bacterium	2026796	S	78	7	85	0.00001
uncultured Thiothrix sp.	223185	S	28	1	29	0.00000
Thiotrichaceae bacterium	2030882	S	16	1	17	0.00000
Vibrio campbellii	680	S	26	51	77	0.00001
Vibrio azureus	512649	S	12	16	28	0.00000
Vibrio chagasii	170679	S	43	162	205	0.00001
Vibrio caribbeanicus	701175	S	35	3	38	0.00000
Vibrio penaeicida	104609	S	22	5	27	0.00000
Vibrio sp. HI00D65	1822216	S	12	41	53	0.00000
Photobacterium sp. GB-56	2022106	S	13	43	56	0.00000
Photobacterium salinisoli	1616783	S	20	64	84	0.00001
Photobacterium angustum	661	S	19	79	98	0.00001
Paraphotobacterium marinum	1755811	S	51	14	65	0.00000
Xanthomonadales bacterium	2006849	S	600	80	680	0.00005
Luteimonas terricola	645597	S	19	12	31	0.00000
Luteibacter sp.	1886636	S	19	2	21	0.00000
Legionellales bacterium	2026754	S	229	23	252	0.00002
Legionella rowbothamii	96229	S	166	23	189	0.00001
Coxiellaceae bacterium	2026727	S	12	3	15	0.00000
Providencia huaxiensis	2027290	S	61	80	141	0.00001
Polycyclovorans sp.	2024852	S	97	124	221	0.00002
Pelagibacteraceae bacterium	2026775	S	428868	281725	710593	0.05139
alpha proteobacterium SCGC AAA288-G21	939324	S	9098	16356	25454	0.00184
Pelagibacteraceae bacterium AG-464-P07	2162008	S	2743	3093	5836	0.00042
alpha proteobacterium SCGC AAA288-E13	939316	S	1818	6625	8443	0.00061
alpha proteobacterium SCGC AAA240-E13	939306	S	1098	2721	3819	0.00028
alpha proteobacterium SCGC AAA288-N07	939346	S	480	737	1217	0.00009
Pelagibacteraceae bacterium AG-464-B04	2162007	S	150	69	219	0.00002
alpha proteobacterium HIMB59	744985	S	17	2	19	0.00000
Pelagibacteraceae bacterium AG-439-F23	2162002	S	16	23	39	0.00000
Pelagibacteraceae bacterium AG-414-E02	2162014	S	14	15	29	0.00000
Pelagibacteraceae bacterium AG-430-P08	2162055	S	13	425	438	0.00003
Pelagibacteraceae bacterium AG-414-M23	2162016	S	13	18	31	0.00000
Candidatus Pelagibacter sp.	2024849	S	100564	101536	202100	0.01462
uncultured Candidatus Pelagibacter sp.	372654	S	106	64	170	0.00001
Candidatus Pelagibacter ubique	198252	S	51	565	616	0.00004
uncultured Pelagibacteraceae bacterium	1667051	S	27549	77100	104649	0.00757
Pelagibacterales bacterium	2026776	S	748	547	1295	0.00009
Pelagibacterales bacterium SAG-MED01	2760004	S	25	39	64	0.00000
Rhodospirillaceae bacterium	1898112	S	183887	26765	210652	0.01523
Rhodospirillaceae bacterium UBA2165	1952852	S	1845	100	1945	0.00014
Rhodospirillaceae bacterium UBA6608	1952863	S	352	48	400	0.00003
Rhodospirillaceae bacterium UBA1479	1952849	S	29	4	33	0.00000
Rhodospirillales bacterium	2026786	S	8040	1161	9201	0.00067
Thalassospira sp. MCCC 1A01148	501834	S	1722	2199	3921	0.00028
Thalassospira sp. MCCC 1A01428	1470575	S	99	61	160	0.00001
Thalassospira povalilytica	732237	S	207	125	332	0.00002
Thalassospira lucentensis	168935	S	28	58	86	0.00001
Thalassospira indica	1891279	S	14	98	112	0.00001
Thalassospira profundimaris	502049	S	13	22	35	0.00000
Magnetovibrio sp.	2024836	S	42	4	46	0.00000
Tistrella mobilis	171437	S	1216	222	1438	0.00010
Nisaea nitritireducens	568392	S	16	23	39	0.00000
Nisaea denitrificans	390877	S	15	22	37	0.00000
Oceanibaculum nanhaiense	1909734	S	60	29	89	0.00001
Citromicrobium sp.	2024827	S	44681	20148	64829	0.00469
Citromicrobium sp. UBA3494	1946345	S	221	221	442	0.00003
Citromicrobium sp. JLT1363	517722	S	117	131	248	0.00002
Citromicrobium bathyomarinum	72174	S	747	671	1418	0.00010
Sphingobium xenophagum	121428	S	5207	9063	14270	0.00103
Sphingobium sp. TCM1	453246	S	1046	1451	2497	0.00018
Sphingobium sp.	1912891	S	287	181	468	0.00003
Sphingobium sp. C100	1207055	S	68	105	173	0.00001
Sphingobium sp. CCH11-B1	1768781	S	58	164	222	0.00002
Sphingobium sp. OAE613	2663803	S	28	9	37	0.00000
Sphingobium sp. D43FB	2017595	S	20	45	65	0.00000
Sphingobium sp. KCTC 72723	2733867	S	19	23	42	0.00000
Sphingobium sp. Ant17	1461752	S	19	48	67	0.00000
Sphingobium yanoikuyae	13690	S	342	929	1271	0.00009
Sphingobium lactosutens	522773	S	170	668	838	0.00006
Sphingobium terrigena	2304063	S	57	176	233	0.00002
Sphingobium algorifonticola	2008318	S	50	31	81	0.00001
Sphingobium abikonense	86193	S	36	117	153	0.00001
Sphingobium scionense	1404341	S	29	77	106	0.00001
Sphingobium limneticum	1007511	S	28	52	80	0.00001
Sphingobium psychrophilum	2728834	S	20	52	72	0.00001
Sphingobium indicum	332055	S	15	25	40	0.00000
Sphingomonas sp. SKA58	314266	S	10986	14858	25844	0.00187
Sphingomonas sp.	28214	S	509	135	644	0.00005
Sphingomonas sp. ATCC 31555	194867	S	64	28	92	0.00001
Sphingomonas sp. 3P27F8	2502213	S	41	93	134	0.00001
Sphingomonas sp. EC-HK361	2038397	S	25	23	48	0.00000
Sphingomonas sp. CCH10-B3	1768757	S	25	59	84	0.00001
Sphingomonas abaci	237611	S	858	882	1740	0.00013
Sphingomonas ursincola	56361	S	204	208	412	0.00003
Sphingomonas ginsenosidimutans	862134	S	122	156	278	0.00002
Sphingomonas corticis	2722791	S	52	29	81	0.00001
Sphingomonas sanxanigenens	397260	S	27	14	41	0.00000
Sphingomonas yabuuchiae	172044	S	26	27	53	0.00000
Novosphingopyxis iocasae	2762729	S	3744	1918	5662	0.00041
Novosphingopyxis baekryungensis	279369	S	102	15	117	0.00001
Novosphingobium indicum	462949	S	933	695	1628	0.00012
Novosphingobium sp. PC22D	1962403	S	22	20	42	0.00000
Novosphingobium sp. GV002	2135687	S	15	5	20	0.00000
Novosphingobium sp. SCN 66-18	1660121	S	14	43	57	0.00000
Novosphingobium silvae	2692619	S	106	169	275	0.00002
Novosphingobium panipatense	428991	S	104	117	221	0.00002
Novosphingobium aquimarinum	2682494	S	88	106	194	0.00001
Novosphingobium barchaimii	1420591	S	79	87	166	0.00001
Novosphingobium fluoreni	1391222	S	19	2	21	0.00000
Novosphingobium marinum	1514948	S	18	14	32	0.00000
Novosphingobium pentaromativorans	205844	S	13	9	22	0.00000
Stakelama pacifica	517720	S	636	380	1016	0.00007
Sphingopyxis sp.	1908224	S	109	70	179	0.00001
Sphingopyxis macrogoltabida	33050	S	29	35	64	0.00000
Sphingopyxis terrae	33052	S	20	24	44	0.00000
Sphingomonadaceae bacterium LXI357	2826939	S	69	22	91	0.00001
Sphingomonadaceae bacterium	1930536	S	64	15	79	0.00001
Sphingomonadaceae bacterium MED-G03	1986231	S	19	7	26	0.00000
Rhizorhabdus sp.	1968843	S	120	147	267	0.00002
uncultured Parasphingopyxis sp.	1547918	S	52	57	109	0.00001
Sphingosinithalassobacter portus	2676234	S	39	12	51	0.00000
Erythrobacter sp. A30-3	2785907	S	12420	13283	25703	0.00186
Erythrobacter sp.	1042	S	5033	2501	7534	0.00054
Erythrobacter sp. HI0063	1822240	S	870	777	1647	0.00012
Erythrobacter sp. 3-20A1M	2653850	S	161	108	269	0.00002
Erythrobacter sp. UBA2510	1946470	S	62	84	146	0.00001
Erythrobacter sp. UBA1916	1946469	S	24	24	48	0.00000
Erythrobacter aureus	2182384	S	4767	1276	6043	0.00044
Erythrobacter litoralis	39960	S	67	55	122	0.00001
Erythrobacter longus	1044	S	61	7	68	0.00000
Qipengyuania citrea	225971	S	1470	1259	2729	0.00020
Qipengyuania flava	192812	S	730	184	914	0.00007
Qipengyuania pelagi	994320	S	200	174	374	0.00003
Qipengyuania vulgaris	291985	S	133	68	201	0.00001
Qipengyuania nanhaisediminis	604088	S	22	23	45	0.00000
Croceicoccus sp.	1927144	S	375	593	968	0.00007
Croceicoccus bisphenolivorans	1783232	S	20	12	32	0.00000
Aurantiacibacter zhengii	2307003	S	87	59	146	0.00001
Aurantiacibacter atlanticus	1648404	S	56	9	65	0.00000
Erythrobacteraceae bacterium	2026738	S	44	3	47	0.00000
Actirhodobacter atriluteus	2744473	S	46	18	64	0.00000
Pelagerythrobacter marinus	538382	S	28	19	47	0.00000
Pseudopontixanthobacter vadosimaris	2726450	S	33	17	50	0.00000
Croceibacterium atlanticum	1267766	S	22	12	34	0.00000
Tsuneonella suprasediminis	2306996	S	18	17	35	0.00000
Pacificimonas flava	1234595	S	158	79	237	0.00002
Sphingomonadales bacterium	1978525	S	97	32	129	0.00001
Sphingomonadales bacterium Ga0077557	1752232	S	30	9	39	0.00000
Thalassobius sp.	1979401	S	29548	8566	38114	0.00276
Salipiger bermudensis	344736	S	7777	5836	13613	0.00098
Salipiger profundus	1229727	S	4044	3287	7331	0.00053
Salipiger thiooxidans	282683	S	599	616	1215	0.00009
Salipiger marinus	555512	S	294	214	508	0.00004
Salipiger abyssi	1250539	S	12	11	23	0.00000
Roseovarius sp.	1486281	S	696	316	1012	0.00007
Roseovarius sp. A-2	1570360	S	15	5	20	0.00000
Roseovarius halotolerans	505353	S	467	496	963	0.00007
Roseovarius indicus	540747	S	109	16	125	0.00001
Roseovarius nitratireducens	2044597	S	57	30	87	0.00001
Roseovarius pacificus	337701	S	21	10	31	0.00000
Roseovarius atlanticus	1641875	S	19	16	35	0.00000
Roseovarius mucosus	215743	S	17	9	26	0.00000
Roseovarius nubinhibens	314263	S	13	5	18	0.00000
Sulfitobacter pontiacus	60137	S	424	435	859	0.00006
Sulfitobacter sp. BDSS02	2663018	S	169	202	371	0.00003
Sulfitobacter sp. R18_2	2821105	S	66	107	173	0.00001
Sulfitobacter sp. D7	1968541	S	18	64	82	0.00001
Sulfitobacter alexandrii	1917485	S	32	8	40	0.00000
Sulfitobacter litoralis	335975	S	29	74	103	0.00001
Sulfitobacter delicatus	218672	S	28	31	59	0.00000
Actibacterium naphthalenivorans	1614693	S	943	1158	2101	0.00015
Maritimibacter sp.	2003363	S	415	139	554	0.00004
Roseobacter sp.	1907202	S	185	45	230	0.00002
Roseobacter sp. MED193	314262	S	127	97	224	0.00002
Maribius pelagius	387096	S	73	135	208	0.00002
Phaeobacter sp. 22II1-1F12B	1317111	S	129	148	277	0.00002
Phaeobacter sp. CECT 5382	1712645	S	40	6	46	0.00000
Sagittula sp. P11	2009329	S	150	56	206	0.00001
Lutimaribacter saemankumensis	490829	S	100	28	128	0.00001
Yangia pacifica	311180	S	57	27	84	0.00001
Tranquillimonas rosea	641238	S	25	5	30	0.00000
Tranquillimonas alkanivorans	441119	S	20	3	23	0.00000
Roseivivax marinus	1379903	S	26	15	41	0.00000
Leisingera caerulea	506591	S	33	8	41	0.00000
Roseicyclus sp.	1914329	S	18	3	21	0.00000
Thiosulfatihalobacter marinus	2792481	S	17	15	32	0.00000
Tropicibacter alexandrii	2267683	S	12	9	21	0.00000
Albimonas donghaensis	356660	S	23721	4405	28126	0.00203
Albimonas pacifica	1114924	S	523	150	673	0.00005
Paracoccaceae bacterium	1904441	S	9977	2392	12369	0.00089
Thioclava sediminum	1915319	S	98	1614	1712	0.00012
Thioclava sp. JE_KL1	2651187	S	40	601	641	0.00005
Thioclava atlantica	1317124	S	40	65	105	0.00001
Thioclava electrotropha	1549850	S	32	538	570	0.00004
Paracoccus sp. UBA889	1947056	S	717	275	992	0.00007
Paracoccus sp. R12_2	2821098	S	198	117	315	0.00002
Paracoccus sp. MKU1	1745182	S	23	44	67	0.00000
Paracoccus denitrificans	266	S	37	30	67	0.00000
Paracoccus halophilus	376733	S	12	6	18	0.00000
Pseudooceanicola atlanticus	1461694	S	369	530	899	0.00007
Pseudooceanicola nanhaiensis	375761	S	54	60	114	0.00001
Pseudooceanicola lipolyticus	2029104	S	25	36	61	0.00000
Pseudooceanicola marinus	396013	S	15	5	20	0.00000
Marinibacterium profundimaris	1679460	S	471	649	1120	0.00008
Allosediminivita pacifica	1267769	S	321	338	659	0.00005
Pacificitalea manganoxidans	1411902	S	278	83	361	0.00003
Vannielia litorea	1217970	S	151	71	222	0.00002
Thalassobium sp.	2030825	S	73	35	108	0.00001
Limimaricola cinnabarinus	1125964	S	41	25	66	0.00000
Tritonibacter mobilis	379347	S	27	13	40	0.00000
Kandeliimicrobium roseum	1737570	S	27	6	33	0.00000
Gemmobacter nectariphilus	220343	S	18	14	32	0.00000
Maliponia aquimaris	1673631	S	17	7	24	0.00000
Arenibacterium halophilum	2583821	S	17	5	22	0.00000
Alphaproteobacteria bacterium UBA7887	1948447	S	49877	6593	56470	0.00408
Alphaproteobacteria bacterium MarineAlpha5_Bin3	2013078	S	23342	1106	24448	0.00177
Alphaproteobacteria bacterium MarineAlpha3_Bin6	2013072	S	1843	144	1987	0.00014
Alphaproteobacteria bacterium	1913988	S	1216	259	1475	0.00011
Alphaproteobacteria bacterium MarineAlpha9_Bin7	2013102	S	545	42	587	0.00004
Alphaproteobacteria bacterium MarineAlpha3_Bin3	2013069	S	504	103	607	0.00004
Alphaproteobacteria bacterium MarineAlpha3_Bin4	2013070	S	485	18	503	0.00004
Alphaproteobacteria bacterium MarineAlpha9_Bin6	2013101	S	214	2	216	0.00002
Alphaproteobacteria bacterium MarineAlpha3_Bin2	2013068	S	159	11	170	0.00001
Alphaproteobacteria bacterium MarineAlpha6_Bin2	2013089	S	75	3	78	0.00001
Alphaproteobacteria bacterium MarineAlpha10_Bin2	2013104	S	69	2	71	0.00001
Alphaproteobacteria bacterium UBA3002	1948380	S	47	1	48	0.00000
Alphaproteobacteria bacterium HT1-32	2665153	S	38	0	38	0.00000
Alphaproteobacteria bacterium UBA828	1948450	S	30	0	30	0.00000
Alphaproteobacteria bacterium MarineAlpha5_Bin12	2013087	S	23	6	29	0.00000
Alphaproteobacteria bacterium MarineAlpha9_Bin1	2013096	S	23	1	24	0.00000
Alphaproteobacteria bacterium MarineAlpha3_Bin7	2013073	S	22	0	22	0.00000
Alphaproteobacteria bacterium MarineAlpha11_Bin1	2013106	S	21	24	45	0.00000
Alphaproteobacteria bacterium UBA7314	1948440	S	21	0	21	0.00000
Alphaproteobacteria bacterium UBA6544	1948430	S	17	2	19	0.00000
Alphaproteobacteria bacterium MarineAlpha5_Bin5	2013080	S	16	0	16	0.00000
Alphaproteobacteria bacterium MarineAlpha9_Bin3	2013098	S	15	3	18	0.00000
alpha proteobacterium MED-G10	2007300	S	15	0	15	0.00000
Alphaproteobacteria bacterium UBA2966	1948377	S	12	4	16	0.00000
Nitratireductor sp.	1872084	S	5423	1376	6799	0.00049
Nitratireductor indicus	721133	S	42	32	74	0.00001
Hoeflea sp.	1940281	S	2189	1125	3314	0.00024
Hoeflea sp. EC-HK425	2038388	S	13	5	18	0.00000
Phyllobacteriaceae bacterium	1871068	S	634	160	794	0.00006
Martelella mediterranea	293089	S	2480	1178	3658	0.00026
Martelella sp. AD-3	686597	S	926	1025	1951	0.00014
Martelella sp. NC20	2740298	S	14	4	18	0.00000
Martelella limonii	1647649	S	19	5	24	0.00000
Fulvimarina sp.	1969479	S	392	353	745	0.00005
Fulvimarina manganoxydans	937218	S	332	20	352	0.00003
Aurantimonas coralicida	182270	S	39	120	159	0.00001
Jiella pacifica	2696469	S	74	28	102	0.00001
Ahrensia sp.	1872419	S	5934	3205	9139	0.00066
Parvibaculum indicum	562969	S	3809	3342	7151	0.00052
Parvibaculum sp.	2024848	S	128	42	170	0.00001
Rhodobiaceae bacterium	2026785	S	2953	668	3621	0.00026
Rhodobiaceae bacterium UBA7804	1952834	S	514	299	813	0.00006
Roseibium aggregatum	187304	S	1613	518	2131	0.00015
Stappia sp.	1870903	S	327	184	511	0.00004
Stappia indica	538381	S	197	222	419	0.00003
Methylobacterium fujisawaense	107400	S	1111	1373	2484	0.00018
Methylobacterium dankookense	560405	S	14	19	33	0.00000
Hyphomicrobiales bacterium	1909294	S	1738	523	2261	0.00016
Rhizobiales bacterium CCH10-E5	1768797	S	65	58	123	0.00001
Filomicrobium sp.	2024831	S	491	31	522	0.00004
Methyloceanibacter sp.	1965321	S	93	23	116	0.00001
Afipia sp. OHSU_II-C1	1297860	S	67	84	151	0.00001
Afipia broomeae	56946	S	28	47	75	0.00001
Bradyrhizobiaceae bacterium PARB1	2015576	S	115	71	186	0.00001
Bosea sp. RAC05	1842539	S	25	109	134	0.00001
Acuticoccus yangtzensis	1443441	S	80	8	88	0.00001
Acuticoccus sediminis	2184697	S	15	1	16	0.00000
Rickettsiales bacterium	2026788	S	34987	7091	42078	0.00304
Hyphomonas adhaerens	81029	S	6815	2299	9114	0.00066
Hyphomonas sp. L-53-1-40	1207058	S	1840	681	2521	0.00018
Hyphomonas sp.	87	S	767	482	1249	0.00009
Hyphomonas sp. CY54-11-8	1280944	S	668	601	1269	0.00009
Hyphomonas sp. UBA5111	1946637	S	144	183	327	0.00002
Hyphomonas sp. BRH_c22	1629710	S	19	39	58	0.00000
Hyphomonas sp. 34-62-18	1970392	S	14	17	31	0.00000
Hyphomonas pacifica	1280941	S	369	559	928	0.00007
Hyphomonas atlantica	1280948	S	343	455	798	0.00006
Hyphomonas chukchiensis	1280947	S	31	59	90	0.00001
Hyphomonas oceanitis	81033	S	30	49	79	0.00001
Hyphomonas beringensis	1280946	S	12	5	17	0.00000
Ponticaulis sp.	2020902	S	4850	983	5833	0.00042
Henriciella sp.	1968823	S	2214	690	2904	0.00021
Henriciella algicola	1608422	S	32	8	40	0.00000
Henriciella aquimarina	545261	S	30	25	55	0.00000
Hyphomonadaceae bacterium TMED5	1986776	S	1669	739	2408	0.00017
Hyphomonadaceae bacterium BRH_c29	1629720	S	25	12	37	0.00000
Hirschia sp.	2024835	S	53	5	58	0.00000
uncultured Alphaproteobacteria bacterium	91750	S	7392	1810	9202	0.00067
Oceanicaulis sp. HTCC2633	314254	S	1706	520	2226	0.00016
Oceanicaulis sp. PT13A	2135616	S	48	10	58	0.00000
Maricaulis maris	74318	S	573	122	695	0.00005
Maricaulis sp.	1486257	S	147	26	173	0.00001
Maricaulis alexandrii	2570354	S	41	12	53	0.00000
Hellea sp.	2715692	S	28	3	31	0.00000
Parvularcula sp.	1979207	S	1100	327	1427	0.00010
Marinicaulis flavus	2058213	S	23	2	25	0.00000
Caulobacter sp. CCH9-E1	1768768	S	149	263	412	0.00003
Caulobacter sp. FWC26	69665	S	97	113	210	0.00002
Caulobacter sp. 602-1	2492472	S	24	19	43	0.00000
Caulobacter sp. FWC2	69664	S	14	10	24	0.00000
Brevundimonas sp. A19_0	2821087	S	13	13	26	0.00000
Caulobacteraceae bacterium UBA3198	1951537	S	23	3	26	0.00000
uncultured SAR116 cluster alpha proteobacterium	281031	S	297	164	461	0.00003
SAR116 cluster bacterium	2024888	S	72	70	142	0.00001
Kordiimonas sp.	1970157	S	91	51	142	0.00001
Kordiimonas pumila	2161677	S	72	0	72	0.00001
Luteithermobacter gelatinilyticus	2582913	S	72	4	76	0.00001
Magnetococcales bacterium	2026759	S	37	0	37	0.00000
Proteobacteria bacterium UBA5680	1948185	S	89132	14255	103387	0.00748
Pseudomonadota bacterium	1977087	S	65836	17622	83458	0.00604
Proteobacteria bacterium UBA2133	1948144	S	1909	53	1962	0.00014
Proteobacteria bacterium UBA1148	1948131	S	1346	180	1526	0.00011
Proteobacteria bacterium UBA2996	1948156	S	177	100	277	0.00002
Proteobacteria bacterium UBA6503	1948193	S	32	3	35	0.00000
Cupriavidus pauculus	82633	S	10369	7954	18323	0.00133
Cupriavidus campinensis	151783	S	303	193	496	0.00004
Cupriavidus sp. 2SB	2502199	S	45	21	66	0.00000
Cupriavidus necator	106590	S	34	59	93	0.00001
Cupriavidus basilensis	68895	S	17	18	35	0.00000
Limnobacter sp. SAORIC-580	2732163	S	358	648	1006	0.00007
Limnobacter sp. MED105	391597	S	33	35	68	0.00000
Limnobacter sp. CACIAM 66H1	1813033	S	14	21	35	0.00000
Limnobacter alexandrii	2570352	S	13	6	19	0.00000
Paraburkholderia azotifigens	2057004	S	13	4	17	0.00000
Variovorax paradoxus	34073	S	3367	8449	11816	0.00085
Variovorax sp. GV040	2135734	S	183	504	687	0.00005
Variovorax sp. SG533	2587118	S	16	37	53	0.00000
Acidovorax sp. KKS102	358220	S	107	472	579	0.00004
Acidovorax sp. NB1	1943571	S	23	82	105	0.00001
Acidovorax sp.	1872122	S	12	27	39	0.00000
Acidovorax delafieldii	47920	S	218	636	854	0.00006
Curvibacter sp.	1888168	S	540	600	1140	0.00008
Delftia acidovorans	80866	S	66	224	290	0.00002
Comamonadaceae bacterium ALPHA2B	2502232	S	154	1199	1353	0.00010
Pelomonas puraquae	431059	S	63	217	280	0.00002
Herbaspirillum huttiense	863372	S	865	1955	2820	0.00020
Pusillimonas sp. UBA3987	1947369	S	1072	617	1689	0.00012
Pusillimonas sp. DMV24BSW_D	2716226	S	13	10	23	0.00000
Pusillimonas maritima	2026239	S	48	53	101	0.00001
Burkholderiales bacterium	1891238	S	85	85	170	0.00001
Rubrivivax sp.	50259	S	14	61	75	0.00001
Xylophilus sp.	2653893	S	20	31	51	0.00000
uncultured Burkholderiales bacterium	208544	S	16	10	26	0.00000
Methylophilus sp.	29541	S	264	108	372	0.00003
Methyloversatilis discipulorum	1119528	S	66	49	115	0.00001
Nitrosomonadaceae bacterium	2026767	S	55	5	60	0.00000
Gallionellaceae bacterium	2052162	S	25	4	29	0.00000
Candidatus Lambdaproteobacteria bacterium	2035771	S	360	26	386	0.00003
uncultured proteobacterium	153809	S	23	3	26	0.00000
Candidatus Marinimicrobia bacterium	2026760	S	1656933	231043	1887976	0.13653
Candidatus Marinimicrobia bacterium UBA7300	1953254	S	533306	272322	805628	0.05826
Candidatus Marinimicrobia bacterium UBA6531	1953244	S	402140	219682	621822	0.04497
Candidatus Marinimicrobia bacterium UBA2125	1953217	S	145547	196077	341624	0.02471
Candidatus Marinimicrobia bacterium UBA7303	1953256	S	34118	10824	44942	0.00325
Candidatus Marinimicrobia bacterium UBA7301	1953255	S	11954	2027	13981	0.00101
Candidatus Marinimicrobia bacterium UBA1611	1953216	S	8329	3861	12190	0.00088
Candidatus Marinimicrobia bacterium 408169	1958814	S	3867	438	4305	0.00031
Candidatus Marinimicrobia bacterium UBA7308	1953257	S	1584	105	1689	0.00012
uncultured Candidatus Marinimicrobia bacterium	195045	S	350	115	465	0.00003
Candidatus Marinimicrobia bacterium UBA6931	1953249	S	254	16	270	0.00002
Marinimicrobia bacterium TCS55	1781246	S	239	27	266	0.00002
Candidatus Marinimicrobia bacterium UBA1134	1953213	S	216	52	268	0.00002
Candidatus Marinimicrobia bacterium REDSEA-S14_B6	1811603	S	169	21	190	0.00001
Marinimicrobia bacterium SCGC AAA003-L08	939844	S	99	0	99	0.00001
Candidatus Marinimicrobia bacterium UBA2986	1953231	S	34	1	35	0.00000
Candidatus Marinimicrobia bacterium UBA2980	1953230	S	22	4	26	0.00000
Flavobacteriaceae bacterium	1871037	S	32300	8059	40359	0.00292
Flavobacteriaceae bacterium UBA4166	1951841	S	1228	25	1253	0.00009
Flavobacteriaceae bacterium UBA3611	1951834	S	119	45	164	0.00001
Flavobacteriaceae bacterium UBA1978	1951807	S	19	0	19	0.00000
Muricauda oceanensis	2499163	S	5378	4242	9620	0.00070
Muricauda sediminis	2696468	S	3150	2735	5885	0.00043
Muricauda sp. ARW1Y1	2663843	S	1513	397	1910	0.00014
Muricauda sp.	192149	S	392	330	722	0.00005
Muricauda sp. MAR_2010_75	1250232	S	33	22	55	0.00000
Muricauda sp. TMED12	1986608	S	20	17	37	0.00000
Muricauda sp. TY007	2683200	S	19	34	53	0.00000
Muricauda sp. CP2A	1848189	S	18	13	31	0.00000
Muricauda ruestringensis	111501	S	1705	1354	3059	0.00022
Muricauda hadalis	2597517	S	659	445	1104	0.00008
Muricauda aequoris	2306997	S	247	226	473	0.00003
Muricauda maritima	2306998	S	240	401	641	0.00005
Muricauda lutaonensis	516051	S	50	7	57	0.00000
Muricauda zhangzhouensis	1073328	S	46	9	55	0.00000
Muricauda oceani	2698672	S	43	47	90	0.00001
Muricauda amoyensis	2169401	S	41	12	53	0.00000
Muricauda olearia	552546	S	25	12	37	0.00000
Muricauda alvinocaridis	2530200	S	18	12	30	0.00000
Muricauda brasiliensis	2162892	S	17	5	22	0.00000
Muricauda lutimaris	475082	S	15	10	25	0.00000
Muricauda beolgyonensis	864064	S	13	1	14	0.00000
Mesonia oceanica	2687242	S	8512	2822	11334	0.00082
Mesonia mobilis	369791	S	136	171	307	0.00002
Mesonia sp.	1960830	S	19	18	37	0.00000
Mesonia aquimarina	1504967	S	18	8	26	0.00000
Leeuwenhoekiella blandensis	360293	S	3421	1856	5277	0.00038
Leeuwenhoekiella palythoae	573501	S	1345	419	1764	0.00013
Leeuwenhoekiella sp.	1977054	S	118	40	158	0.00001
Leeuwenhoekiella nanhaiensis	1655491	S	47	23	70	0.00001
Leeuwenhoekiella polynyae	1550906	S	22	58	80	0.00001
Winogradskyella sp.	1883156	S	3685	969	4654	0.00034
Zunongwangia profunda	398743	S	2443	2754	5197	0.00038
Zunongwangia mangrovi	1334022	S	121	53	174	0.00001
Zunongwangia atlantica	1502297	S	101	60	161	0.00001
Joostella marina	453852	S	2194	1340	3534	0.00026
Mesoflavibacter zeaxanthinifaciens	393060	S	1209	652	1861	0.00013
Mesoflavibacter profundi	2708110	S	43	23	66	0.00000
Flavobacterium sp.	239	S	766	354	1120	0.00008
Aequorivita sp.	1872390	S	305	329	634	0.00005
Aequorivita sp. UBA3180	1947773	S	12	13	25	0.00000
Aequorivita aquimaris	1548749	S	106	212	318	0.00002
Salegentibacter mishustinae	270918	S	128	216	344	0.00002
Salegentibacter sp. R32	1486285	S	51	23	74	0.00001
Aquimarina sp.	1872586	S	149	33	182	0.00001
Maribacter dokdonensis	320912	S	72	38	110	0.00001
Maribacter cobaltidurans	1178778	S	27	24	51	0.00000
Arenibacter algicola	616991	S	39	29	68	0.00000
Arenibacter aquaticus	2489054	S	29	2	31	0.00000
Arenibacter sp. P308M17	2303391	S	21	4	25	0.00000
Euzebyella marina	1761453	S	117	92	209	0.00002
Croceibacter atlanticus	313588	S	112	13	125	0.00001
Marinirhabdus gelatinilytica	1703343	S	70	23	93	0.00001
Christiangramia portivictoriae	326069	S	17	14	31	0.00000
Christiangramia flava	1486245	S	13	7	20	0.00000
Candidatus Ulvibacter alkanivorans	2267620	S	48	16	64	0.00000
Altibacter sp.	2024823	S	33	1	34	0.00000
Altibacter lentus	1223410	S	12	3	15	0.00000
Tenacibaculum sp. SZ-18	754423	S	20	2	22	0.00000
Tenacibaculum sp. SG-28	754426	S	16	1	17	0.00000
Pukyongia salina	2094025	S	41	24	65	0.00000
Mangrovimonas yunxiaonensis	1197477	S	27	7	34	0.00000
Luteirhabdus pelagi	2792783	S	17	4	21	0.00000
Psychroflexus aestuariivivens	1795040	S	16	2	18	0.00000
Marixanthomonas ophiurae	387659	S	12	5	17	0.00000
Xanthomarina gelatinilytica	1137281	S	14	1	15	0.00000
Flavobacteriales bacterium UBA7878	1951087	S	8686	2138	10824	0.00078
Flavobacteriales bacterium	2021391	S	5432	644	6076	0.00044
Flavobacteriales bacterium UBA852	1951088	S	1207	49	1256	0.00009
Flavobacteriales bacterium UBA2104	1950971	S	83	5	88	0.00001
Flavobacteriales bacterium UBA5081	1951031	S	33	2	35	0.00000
Flavobacteriales bacterium UBA6770	1951056	S	22	1	23	0.00000
Flavobacteriales bacterium 32-35-8	1970509	S	17	7	24	0.00000
Acidiluteibacter ferrifornacis	2692424	S	5349	435	5784	0.00042
Cryomorphaceae bacterium	1898111	S	50	11	61	0.00000
Owenweeksia sp.	2024847	S	1560	42	1602	0.00012
Croceimicrobium hydrocarbonivorans	2761580	S	29	9	38	0.00000
Crocinitomicaceae bacterium	2026728	S	192	27	219	0.00002
uncultured Flavobacteriales bacterium	213322	S	24	2	26	0.00000
Bacteroidota bacterium	1898104	S	29531	2477	32008	0.00231
Cyclobacterium marinum	104	S	989	193	1182	0.00009
Algoriphagus iocasae	1836499	S	44	32	76	0.00001
Algoriphagus sp. Y33	2772483	S	15	4	19	0.00000
Roseivirga spongicola	333140	S	314	34	348	0.00003
Roseivirga seohaensis	1914963	S	207	30	237	0.00002
Roseivirga pacifica	1267423	S	21	0	21	0.00000
Flammeovirgaceae bacterium UBA7330	1951792	S	444	69	513	0.00004
Flammeovirgaceae bacterium	2026740	S	59	11	70	0.00001
Cytophagaceae bacterium	2026729	S	122	22	144	0.00001
Marivirga atlantica	1548457	S	57	8	65	0.00000
Marivirga lumbricoides	1046115	S	39	10	49	0.00000
uncultured Marinoscillum sp.	932004	S	60	6	66	0.00000
Cytophagales bacterium Alg240-R148	2305985	S	15	1	16	0.00000
Cytophagia bacterium	2026730	S	40	41	81	0.00001
Bacteroidales bacterium	2030927	S	1178	97	1275	0.00009
Lentimicrobiaceae bacterium	2026756	S	172	9	181	0.00001
Bacteroides sp.	29523	S	17	1	18	0.00000
Mariniphaga sp.	1954475	S	26	0	26	0.00000
uncultured Bacteroidetes bacterium	152509	S	1378	296	1674	0.00012
Saprospirales bacterium	2026790	S	529	25	554	0.00004
Ignavibacteriota bacterium	2026749	S	7244	180	7424	0.00054
Balneolaceae bacterium UBA7797	1951519	S	1301	166	1467	0.00011
Balneola sp.	2024824	S	210	167	377	0.00003
Balneola sp. EhC07	1849360	S	16	62	78	0.00001
Rubrivirga sp. SAORIC476	1961794	S	588	244	832	0.00006
Gemmatimonadota bacterium	2026742	S	77713	12796	90509	0.00655
Gemmatimonadaceae bacterium	2026741	S	30004	7625	37629	0.00272
Gemmatimonadales bacterium UBA7889	1951131	S	3868	11433	15301	0.00111
Gemmatimonadales bacterium UBA1120	1951099	S	1508	8123	9631	0.00070
Gemmatimonadales bacterium UBA1142	1951102	S	162	49	211	0.00002
Gemmatimonadales bacterium UBA2988	1951110	S	113	1	114	0.00001
Gemmatimonadales bacterium UBA2975	1951107	S	39	65	104	0.00001
Gemmatimonadales bacterium UBA2982	1951109	S	34	0	34	0.00000
Gemmatimonadales bacterium UBA2989	1951111	S	30	11	41	0.00000
Candidatus Latescibacteria bacterium	2053570	S	2029	155	2184	0.00016
Latescibacteria bacterium UBA6620	1948115	S	68	0	68	0.00000
Candidatus Latescibacter anaerobius	1432313	S	13	0	13	0.00000
Candidatus Microthrix sp. UBA2131	1946167	S	232135	169239	401374	0.02903
Candidatus Microthrix sp. UBA3125	1946176	S	222595	188381	410976	0.02972
Candidatus Microthrix sp. UBA4542	1946188	S	2859	1283	4142	0.00030
Candidatus Microthrix sp. UBA7884	1946214	S	1887	2675	4562	0.00033
Candidatus Microthrix sp. UBA7388	1946207	S	115	3	118	0.00001
Candidatus Microthrix sp. UBA814	1946218	S	102	17	119	0.00001
Candidatus Microthrix sp. UBA672	1946197	S	87	50	137	0.00001
Candidatus Microthrix sp. UBA2110	1946164	S	40	117	157	0.00001
Candidatus Microthrix sp. UBA2974	1946174	S	29	1	30	0.00000
Candidatus Microthrix sp. UBA825	1946219	S	23	2	25	0.00000
Candidatus Microthrix sp. UBA2983	1946175	S	13	4	17	0.00000
Acidimicrobiaceae bacterium	2024894	S	13108	2544	15652	0.00113
Acidimicrobiaceae bacterium UBA7830	1951343	S	22	0	22	0.00000
Acidimicrobiales bacterium	2201156	S	521	145	666	0.00005
Acidimicrobiales bacterium AG-414-N20	2162616	S	12	4	16	0.00000
Ilumatobacteraceae bacterium	2497619	S	255	119	374	0.00003
Acidimicrobiia bacterium	2080302	S	361	108	469	0.00003
Microbacterium sp. UBA1097	1946941	S	47875	36866	84741	0.00613
Microbacterium sp.	51671	S	53	16	69	0.00000
Microbacterium sp. 67-17	1895782	S	28	16	44	0.00000
Microbacterium sp. T32	1776083	S	23	13	36	0.00000
Microbacterium luteum	2782167	S	418	455	873	0.00006
Microbacterium schleiferi	69362	S	48	17	65	0.00000
Microbacterium ginsengisoli	400772	S	39	15	54	0.00000
Microbacterium testaceum	2033	S	33	7	40	0.00000
Microbacteriaceae bacterium UBA1487	1952239	S	7344	3888	11232	0.00081
Chryseoglobus indicus	2750620	S	184	166	350	0.00003
Marinisubtilis pacificus	2591847	S	151	137	288	0.00002
Microcella flavibacter	1804990	S	20	7	27	0.00000
uncultured Schumannella sp.	1195956	S	12	3	15	0.00000
Brevibacterium sp. W7.2	2823518	S	479	1103	1582	0.00011
Brevibacterium sp. XM4083	2583238	S	22	60	82	0.00001
Brevibacterium casei	33889	S	65	87	152	0.00001
Ornithinimicrobium sp. CNJ-824	1904966	S	124	40	164	0.00001
Serinicoccus chungangensis	767452	S	20	16	36	0.00000
Kocuria palustris	71999	S	12	28	40	0.00000
Dermacoccus nishinomiyaensis	1274	S	40	15	55	0.00000
Micrococcales bacterium	2026762	S	30	6	36	0.00000
Brachybacterium paraconglomeratum	173362	S	15	19	34	0.00000
Demequina sp. NBRC 110052	1570341	S	18	3	21	0.00000
Actinomycetia bacterium	1883427	S	51880	11944	63824	0.00462
OCS155 cluster bacterium AG-426-D23	2162610	S	43	39	82	0.00001
OCS155 cluster bacterium AG-333-G23	2162605	S	25	8	33	0.00000
Mycolicibacterium poriferae	39694	S	2829	5518	8347	0.00060
Mycolicibacterium hippocampi	659824	S	247	140	387	0.00003
Mycolicibacterium vinylchloridicum	2736928	S	26	50	76	0.00001
Mycolicibacterium chlorophenolicum	37916	S	20	60	80	0.00001
Mycolicibacterium flavescens	1776	S	19	34	53	0.00000
Mycolicibacterium gilvum	1804	S	12	20	32	0.00000
Mycobacterium sp. PO1	1882219	S	274	529	803	0.00006
Mycobacterium sp. shizuoka-1	2039281	S	23	27	50	0.00000
Gordonia sp. (in: high G+C Gram-positive bacteria)	84139	S	1256	527	1783	0.00013
Lawsonella clevelandensis	1528099	S	44	14	58	0.00000
Nocardioides sp.	35761	S	3003	846	3849	0.00028
Nocardioides sp. REDSEA-S33_B3	1811554	S	141	92	233	0.00002
Nocardioides salarius	374513	S	28	13	41	0.00000
Nocardioides marinus	374514	S	17	8	25	0.00000
Pimelobacter sp.	51662	S	48	47	95	0.00001
Cutibacterium acnes	1747	S	190	248	438	0.00003
Cutibacterium namnetense	1574624	S	13	3	16	0.00000
uncultured Candidatus Actinomarina sp.	1985113	S	1624	1145	2769	0.00020
Pseudonocardia alni	33907	S	88	102	190	0.00001
Euzebya pacifica	1608957	S	52	17	69	0.00000
Dehalococcoidia bacterium UBA2158	1948480	S	125964	46697	172661	0.01249
Dehalococcoidia bacterium UBA1122	1948466	S	13202	713	13915	0.00101
Dehalococcoidia bacterium UBA7891	1948532	S	12884	5779	18663	0.00135
Dehalococcoidia bacterium UBA2162	1948482	S	12103	677	12780	0.00092
Dehalococcoidia bacterium UBA6495	1948511	S	9607	11287	20894	0.00151
Dehalococcoidia bacterium UBA7894	1948533	S	7662	4260	11922	0.00086
Dehalococcoidia bacterium	2026734	S	5728	639	6367	0.00046
Dehalococcoidia bacterium UBA2160	1948481	S	750	111	861	0.00006
Dehalococcoidia bacterium UBA1152	1948471	S	331	91	422	0.00003
Dehalococcoidia bacterium UBA1123	1948467	S	323	343	666	0.00005
Dehalococcoidia bacterium UBA1332	1948476	S	256	186	442	0.00003
Dehalococcoidia bacterium UBA1151	1948470	S	255	19	274	0.00002
Dehalococcoidia bacterium UBA1141	1948469	S	175	31	206	0.00001
Dehalococcoidia bacterium UBA1127	1948468	S	32	0	32	0.00000
Dehalococcoidia bacterium UBA1328	1948475	S	31	9	40	0.00000
Dehalococcoidales bacterium	2026733	S	27796	2262	30058	0.00217
uncultured Dehalococcoidales bacterium	2006128	S	98	15	113	0.00001
Chloroflexota bacterium	2026724	S	98668	11111	109779	0.00794
Chloroflexi bacterium UBA6622	1947840	S	236	581	817	0.00006
Anaerolineaceae bacterium	2024896	S	5718	450	6168	0.00045
Anaerolineales bacterium UBA1136	1950187	S	1259	143	1402	0.00010
Anaerolineales bacterium UBA832	1950226	S	165	110	275	0.00002
Anaerolineales bacterium UBA3001	1950202	S	134	405	539	0.00004
Anaerolineales bacterium UBA3499	1950205	S	42	107	149	0.00001
SAR202 cluster bacterium	2030829	S	5666	3127	8793	0.00064
SAR202 cluster bacterium AC-647-N09_OGT_505m	2587833	S	443	16	459	0.00003
SAR202 cluster bacterium AC-409-J13_OGT_754m	2587834	S	65	0	65	0.00000
SAR202 cluster bacterium AC-647-P02_OGT_505m	2587832	S	30	10	40	0.00000
SAR202 cluster bacterium AG-426-M11	2162586	S	26	13	39	0.00000
SAR202 cluster bacterium AD-804-J14_MRT_500m	2587836	S	15	0	15	0.00000
uncultured Prochlorococcus sp.	159733	S	224	2923	3147	0.00023
Prochlorococcus marinus	1219	S	203	1006	1209	0.00009
Cyanobium sp. ARS6	2024869	S	853	292	1145	0.00008
Synechococcus sp. MIT S9220	166309	S	164	578	742	0.00005
Synechococcus sp. AG-679-B05	2161966	S	45	295	340	0.00002
Synechococcus sp. BIOS-E4-1	1400864	S	36	44	80	0.00001
Synechococcus sp. CPC35	2024880	S	18	16	34	0.00000
Synechococcus sp. AG-679-D13	2161954	S	17	95	112	0.00001
Synechococcus sp. UW179A	2575510	S	16	16	32	0.00000
Synechococcus sp. AG-679-C18	2161967	S	12	2	14	0.00000
Candidatus Margulisbacteria bacterium	2053573	S	24	3	27	0.00000
Candidatus Saganbacteria bacterium	2575572	S	13	0	13	0.00000
Staphylococcus warneri	1292	S	31	49	80	0.00001
Staphylococcus hominis	1290	S	23	12	35	0.00000
Staphylococcus capitis	29388	S	17	10	27	0.00000
Staphylococcus epidermidis	1282	S	16	38	54	0.00000
Staphylococcus saccharolyticus	33028	S	13	3	16	0.00000
Salinicoccus roseus	45670	S	42	29	71	0.00001
Bacillus subtilis	1423	S	13	55	68	0.00000
Clostridia bacterium	2044939	S	14	1	15	0.00000
Mycoplasmatales bacterium	2023991	S	40	2	42	0.00000
Deltaproteobacteria bacterium	2026735	S	474701	36850	511551	0.03699
SAR324 cluster bacterium SAR324-CTD7B	1795556	S	50824	256230	307054	0.02221
uncultured SAR324 cluster bacterium	179114	S	34272	53383	87655	0.00634
SAR324 cluster bacterium REDSEA-S27_B3	1811637	S	2123	164	2287	0.00017
SAR324 cluster bacterium	2024889	S	1036	44	1080	0.00008
SAR324 cluster bacterium lautmerah10	1764262	S	306	82	388	0.00003
SAR324 cluster bacterium JCVI-SC AAA005	1073573	S	12	12	24	0.00000
Planctomycetaceae bacterium	2026779	S	85973	14854	100827	0.00729
Planctomycetaceae bacterium UBA2972	1952733	S	100	1	101	0.00001
Planctomycetaceae bacterium TMED10	1986833	S	14	1	15	0.00000
Gimesia panareensis	2527978	S	325	101	426	0.00003
Gimesia benthica	2608982	S	22	77	99	0.00001
Gimesia chilikensis	2605989	S	18	55	73	0.00001
Rubinisphaera brasiliensis	119	S	511	21	532	0.00004
Planctomyces sp.	37635	S	93	7	100	0.00001
Symmachiella dynata	2527995	S	24	13	37	0.00000
Fuerstiella sp.	1936112	S	32	0	32	0.00000
Planctomycetales bacterium ZRK34	2723666	S	50	2	52	0.00000
Blastopirellula marina	124	S	833	33	866	0.00006
Rhodopirellula sp.	2024855	S	209	50	259	0.00002
Mariniblastus sp.	2005381	S	48	2	50	0.00000
Pirellulales bacterium	2715253	S	59	5	64	0.00000
Phycisphaerales bacterium	2052180	S	44288	6183	50471	0.00365
Phycisphaerales bacterium UBA7812	1951207	S	397	62	459	0.00003
Phycisphaerales bacterium UBA1910	1951186	S	136	15	151	0.00001
Phycisphaeraceae bacterium	2026777	S	225	34	259	0.00002
Phycisphaera sp. TMED24	1986832	S	124	158	282	0.00002
Phycisphaerae bacterium	2026778	S	14467	6072	20539	0.00149
Candidatus Scalindua arabica	1127984	S	29139	13884	43023	0.00311
Candidatus Scalindua rubra	1872076	S	1208	246	1454	0.00011
Candidatus Scalindua sediminis	2798304	S	437	53	490	0.00004
Candidatus Scalindua sp.	2268189	S	115	73	188	0.00001
Candidatus Scalindua japonica	1284222	S	13	9	22	0.00000
Candidatus Brocadiaceae bacterium S225	2528033	S	63	141	204	0.00001
Planctomycetes bacterium UBA7888	1948130	S	18490	285	18775	0.00136
Planctomycetota bacterium	2026780	S	15579	4846	20425	0.00148
Planctomycetes bacterium RIFCSPLOWO2_12_FULL_40_19	1801983	S	280	47	327	0.00002
Planctomycetes bacterium UBA1662	1948126	S	87	76	163	0.00001
Planctomycetes bacterium UBA1135	1948124	S	27	3	30	0.00000
Puniceicoccaceae bacterium	2026784	S	124300	8177	132477	0.00958
Opitutae bacterium	2026771	S	518	123	641	0.00005
Opitutae bacterium UBA7441	1948740	S	100	24	124	0.00001
Opitutae bacterium UBA7876	1948743	S	54	1	55	0.00000
Opitutae bacterium UBA3534	1948719	S	24	0	24	0.00000
uncultured Opitutales bacterium	592834	S	67	5	72	0.00001
Opitutales bacterium UBA5694	1951179	S	27	2	29	0.00000
Opitutales bacterium	2026772	S	17	3	20	0.00000
Opitutaceae bacterium	2006848	S	16	2	18	0.00000
Akkermansiaceae bacterium UBA7890	1951374	S	24616	13566	38182	0.00276
Akkermansiaceae bacterium UBA4145	1951361	S	36	57	93	0.00001
Akkermansiaceae bacterium UBA1506	1951351	S	25	6	31	0.00000
Akkermansiaceae bacterium UBA1518	1951353	S	12	10	22	0.00000
Verrucomicrobiales bacterium	2026801	S	7354	2304	9658	0.00070
Roseibacillus sp.	2024856	S	405	112	517	0.00004
Verrucomicrobia subdivision 3 bacterium	2052186	S	75	8	83	0.00001
Pedosphaera sp.	2024890	S	36	9	45	0.00000
uncultured Verrucomicrobiales bacterium	100234	S	43	10	53	0.00000
Verrucomicrobiae bacterium	2499141	S	18	4	22	0.00000
Verrucomicrobiota bacterium	2026799	S	13312	4460	17772	0.00129
Verrucomicrobia bacterium UBA673	1948281	S	114	678	792	0.00006
Verrucomicrobia bacterium UBA6775	1948282	S	66	324	390	0.00003
Verrucomicrobia bacterium Opi.OSU.00C	2067063	S	15	0	15	0.00000
uncultured Verrucomicrobiota bacterium	156588	S	199	66	265	0.00002
Chlamydiia bacterium	2052156	S	49	1	50	0.00000
Waddliaceae bacterium	2026802	S	13	0	13	0.00000
Acidobacteriota bacterium	1978231	S	207465	15252	222717	0.01611
Acidobacteria bacterium UBA823	1953113	S	1248	761	2009	0.00015
Acidobacteria bacterium UBA2161	1953103	S	156	270	426	0.00003
Acidobacteria bacterium UBA2999	1953107	S	75	5	80	0.00001
Acidobacteria bacterium UBA2994	1953106	S	24	34	58	0.00000
Acidobacteria bacterium UBA2990	1953105	S	17	7	24	0.00000
Candidatus Poribacteria bacterium	2026781	S	43432	1239	44671	0.00323
Parcubacteria group bacterium	2026774	S	19383	1236	20619	0.00149
Candidatus Uhrbacteria bacterium	2053634	S	1853	95	1948	0.00014
Candidatus Magasanikbacteria bacterium	2026717	S	912	21	933	0.00007
Candidatus Kaiserbacteria bacterium	2030810	S	52	3	55	0.00000
Patescibacteria group bacterium UBA6532	1948854	S	5898	33	5931	0.00043
Patescibacteria group bacterium UBA2163	1948796	S	1235	20	1255	0.00009
Patescibacteria group bacterium	2052139	S	504	27	531	0.00004
Patescibacteria group bacterium UBA2135	1948793	S	359	1	360	0.00003
Candidatus Woesebacteria bacterium	2026804	S	87	1	88	0.00001
Candidatus Peribacter sp. UBA2144	1961372	S	1361	1419	2780	0.00020
Candidatus Peribacter sp. UBA6535	1961374	S	129	5	134	0.00001
Candidatus Saccharibacteria bacterium	2026720	S	788	39	827	0.00006
Candidatus Saccharibacteria bacterium UBA2112	1953324	S	283	1	284	0.00002
Candidatus Saccharibacteria bacterium UBA4215	1953341	S	195	10	205	0.00001
Candidatus Aminicenantes bacterium	2052149	S	1231	37	1268	0.00009
Candidatus Dadabacteria bacterium UBA1144	1953208	S	136	9	145	0.00001
Candidatus Aerophobetes bacterium Ae_b3a	2012485	S	40	29	69	0.00000
candidate division NC10 bacterium SPGG6	1842517	S	22	0	22	0.00000
Candidatus Binatota bacterium	2528255	S	13	8	21	0.00000
Halobacteriovoraceae bacterium	2026745	S	39111	1219	40330	0.00292
Halobacteriovorax sp.	2020862	S	217	32	249	0.00002
Halobacteriovorax sp. JY17	2014617	S	147	7	154	0.00001
Bacteriovoracaceae bacterium	2081706	S	116	39	155	0.00001
Bacteriovoracaceae bacterium UBA7317	1961497	S	30	1	31	0.00000
Micavibrio sp.	2024841	S	22188	3076	25264	0.00183
Micavibrio sp. TMED2	1986633	S	9941	6829	16770	0.00121
Micavibrio sp. TMED27	1986607	S	414	258	672	0.00005
Micavibrio sp. UBA1672	1946908	S	172	16	188	0.00001
Micavibrio sp. UBA2137	1946913	S	81	13	94	0.00001
Micavibrio sp. UBA1850	1946909	S	24	2	26	0.00000
Micavibrio sp. UBA5572	1946924	S	14	1	15	0.00000
Bdellovibrionaceae bacterium UBA6502	1961516	S	215	22	237	0.00002
Pseudobdellovibrionaceae bacterium	2026715	S	100	5	105	0.00001
Bdellovibrionaceae bacterium UBA3535	1961513	S	44	0	44	0.00000
Bdellovibrionaceae bacterium UBA6776	1961519	S	36	0	36	0.00000
Nitrospinota bacterium	2026769	S	32543	2160	34703	0.00251
Candidatus Nitromaritima sp. SCGC AAA288-L16	913337	S	6590	1437	8027	0.00058
Nitrospinaceae bacterium UBA7883	1953054	S	4716	132	4848	0.00035
Nitrospinaceae bacterium	2358456	S	654	115	769	0.00006
Nitrospina sp.	2024844	S	2070	442	2512	0.00018
uncultured Nitrospinaceae bacterium	407034	S	48	28	76	0.00001
Desulfobacteraceae bacterium UBA2156	1961529	S	30409	15589	45998	0.00333
Candidatus Desulfobacula maris	2841694	S	370	189	559	0.00004
Desulfobacterales bacterium	2044940	S	221	45	266	0.00002
Pseudodesulfovibrio profundus	57320	S	38	35	73	0.00001
Desulfofustis glycolicus	51195	S	16	12	28	0.00000
Desulforhopalus singaporensis	91360	S	14	0	14	0.00000
Nitrospiraceae bacterium	2026770	S	31505	687	32192	0.00233
Nitrospiraceae bacterium UBA2166	1952976	S	1402	613	2015	0.00015
Nitrospira sp.	70125	S	31	2	33	0.00000
Nitrospirales bacterium	2358460	S	1102	49	1151	0.00008
Sandaracinus sp.	2024858	S	13178	909	14087	0.00102
Myxococcales bacterium	2026763	S	177	6	183	0.00001
Myxococcales bacterium UBA1660	1961462	S	25	1	26	0.00000
Spirochaetales bacterium	2026792	S	8302	274	8576	0.00062
Spirochaetaceae bacterium	1898206	S	1487	50	1537	0.00011
Spirochaeta sp. UBA1101	1947540	S	100	2	102	0.00001
Spirochaetia bacterium	2053615	S	12	1	13	0.00000
Fusobacteriia bacterium UBA1095	1948575	S	1180	11	1191	0.00009
Fusobacterium nucleatum	851	S	13	4	17	0.00000
bacterium	1869227	S	813	669	1482	0.00011
bacterium MnTg04	2080454	S	17	3	20	0.00000
Sulfurimonas sp.	2022749	S	683	86	769	0.00006
Sulfurovum sp.	1969726	S	39	4	43	0.00000
uncultured bacterium	77133	S	141	206	347	0.00003
uncultured PS1 clade bacterium	1118065	S	38	48	86	0.00001
Marine Group I thaumarchaeote	2511932	S	54562	309444	364006	0.02632
Thaumarchaeota archaeon SCGC AAA007-O23	913333	S	15087	154291	169378	0.01225
uncultured marine group I thaumarchaeote	360837	S	682	1536	2218	0.00016
Marine Group I thaumarchaeote SCGC AAA799-O18	1502294	S	421	229	650	0.00005
Candidatus Nitrosopelagicus sp.	2026808	S	13841	70512	84353	0.00610
Thaumarchaeota archaeon UBA141	1915753	S	11834	10222	22056	0.00160
Nitrososphaerota archaeon	2026795	S	5045	6823	11868	0.00086
Candidatus Bathyarchaeota archaeon	2026714	S	34996	1924	36920	0.00267
Candidatus Methanosuratincola sp.	2495426	S	36	7	43	0.00000
Euryarchaeota archaeon UBA136	1915770	S	68720	55010	123730	0.00895
Euryarchaeota archaeon UBA488	1915775	S	1000	604	1604	0.00012
Marine Group III euryarchaeote CG-Bathy1	1889001	S	187	20	207	0.00001
uncultured marine group III euryarchaeote	360836	S	12	0	12	0.00000
Euryarchaeota archaeon UBA528	1915914	S	16095	5979	22074	0.00160
Candidatus Poseidoniales archaeon	2163009	S	1618	424	2042	0.00015
Euryarchaeota archaeon UBA623	1915969	S	353	50	403	0.00003
Euryarchaeota archaeon UBA19	1915829	S	130	50	180	0.00001
Euryarchaeota archaeon UBA13	1915805	S	124	30	154	0.00001
Euryarchaeota archaeon UBA28	1915871	S	39	5	44	0.00000
Euryarchaeota archaeon UBA86	1915978	S	38	12	50	0.00000
Euryarchaeota archaeon UBA121	1915796	S	37	4	41	0.00000
Euryarchaeota archaeon UBA128	1915803	S	37	4	41	0.00000
Euryarchaeota archaeon UBA439	1915887	S	34	44	78	0.00001
Euryarchaeota archaeon UBA250	1915859	S	32	21	53	0.00000
Euryarchaeota archaeon UBA438	1915886	S	28	5	33	0.00000
Euryarchaeota archaeon UBA220	1915845	S	25	2	27	0.00000
Euryarchaeota archaeon UBA23	1915854	S	23	4	27	0.00000
Euryarchaeota archaeon UBA558	1915936	S	23	3	26	0.00000
Euryarchaeota archaeon UBA487	1915899	S	22	3	25	0.00000
Euryarchaeota archaeon UBA126	1915801	S	21	29	50	0.00000
Marine group II euryarchaeote REDSEA-S11_B3N4	1811651	S	20	40	60	0.00000
Euryarchaeota archaeon UBA552	1915930	S	19	0	19	0.00000
Euryarchaeota archaeon UBA54	1915920	S	16	8	24	0.00000
Marine Group II euryarchaeote MED-G34	2007295	S	16	2	18	0.00000
Euryarchaeota archaeon UBA602	1915954	S	14	2	16	0.00000
Euryarchaeota archaeon UBA39	1915881	S	12	1	13	0.00000
Candidatus Thalassarchaeaceae archaeon	2670411	S	408	257	665	0.00005
Candidatus Thalassoarchaea betae	2599289	S	130	62	192	0.00001
uncultured Candidatus Poseidoniales archaeon	274854	S	172	82	254	0.00002
Candidatus Poseidoniaceae archaeon	2666346	S	71	36	107	0.00001
Euryarchaeota archaeon	2026739	S	95812	14212	110024	0.00796
Euryarchaeota archaeon UBA24	1915765	S	21	0	21	0.00000
Haloferax volcanii	2246	S	32	367	399	0.00003
Marine Group IV archaeon HikBin4	2675329	S	25	1	26	0.00000
Candidatus Pacearchaeota archaeon	2026773	S	41998	1819	43817	0.00317
Candidatus Woesearchaeota archaeon	2026803	S	2323	63	2386	0.00017
Candidatus Woesearchaeota archaeon UBA489	1916024	S	1352	10	1362	0.00010
Nanoarchaeota archaeon	2026764	S	819	32	851	0.00006
archaeon	1906665	S	16150	837	16987	0.00123
Candidatus Lokiarchaeota archaeon Loki_b32	2012491	S	13	0	13	0.00000
