name	taxonomy_id	taxonomy_lvl	kraken_assigned_reads	added_reads	new_est_reads	fraction_total_reads
Alteromonas macleodii	28108	S	133731	288483	422214	0.03679
Alteromonas sp. RKMC-009	2267264	S	12652	2595	15247	0.00133
Alteromonas sp. IB21	2779369	S	4039	4241	8280	0.00072
Alteromonas sp. KUL42	2480797	S	503	79	582	0.00005
Alteromonas sp. BL110	1714845	S	298	477	775	0.00007
Alteromonas sp. KUL106	2480799	S	239	100	339	0.00003
Alteromonas sp. KUL49	2480798	S	175	11	186	0.00002
Alteromonas sp. V450	1912139	S	81	59	140	0.00001
Alteromonas sp. 38	2653129	S	57	63	120	0.00001
Alteromonas sp. ALT199	1298865	S	48	62	110	0.00001
Alteromonas sp. KC3	2795688	S	33	10	43	0.00000
Alteromonas australica	589873	S	11722	5662	17384	0.00151
Alteromonas alba	2079529	S	7111	53661	60772	0.00530
Alteromonas oceani	2071609	S	5277	20389	25666	0.00224
Alteromonas abrolhosensis	1892904	S	5113	6963	12076	0.00105
Alteromonas marina	203795	S	3960	8069	12029	0.00105
Alteromonas mediterranea	314275	S	3220	4473	7693	0.00067
Alteromonas antoniana	2803813	S	1351	1108	2459	0.00021
Alteromonas profundi	2696062	S	1140	702	1842	0.00016
Alteromonas portus	2565549	S	1116	1216	2332	0.00020
Alteromonas genovensis	471225	S	232	204	436	0.00004
Alteromonas naphthalenivorans	715451	S	226	406	632	0.00006
Alteromonas gracilis	1479524	S	209	155	364	0.00003
Alteromonas oceanisediminis	2836180	S	199	43	242	0.00002
Alteromonas pelagimontana	1858656	S	126	19	145	0.00001
Alteromonas confluentis	1656094	S	79	10	89	0.00001
Alteromonas lipolytica	1856405	S	57	9	66	0.00001
Alteromonas aestuariivivens	1938339	S	35	1	36	0.00000
Alteromonas hispanica	315421	S	34	5	39	0.00000
Alteromonas halophila	516698	S	30	5	35	0.00000
Alteromonas lipotrueiana	2803815	S	22	5	27	0.00000
Salinimonas lutimaris	914153	S	2197	569	2766	0.00024
Salinimonas iocasae	2572577	S	1069	404	1473	0.00013
Salinimonas sediminis	2303538	S	114	85	199	0.00002
Salinimonas profundi	2729140	S	64	47	111	0.00001
Salinimonas chungwhensis	265425	S	62	13	75	0.00001
Salinimonas marina	2785918	S	29	5	34	0.00000
Alteromonadaceae bacterium UBA2620	1951386	S	26849	96438	123287	0.01074
Alteromonadaceae bacterium	1916082	S	4824	2261	7085	0.00062
Alteromonadaceae bacterium XY-R5	1737567	S	22	1	23	0.00000
Marisediminitalea aggregata	634436	S	3211	542	3753	0.00033
Glaciecola sp. UBA1851	1946570	S	181	23	204	0.00002
Glaciecola sp. HTCC2999	455436	S	51	7	58	0.00001
Aestuariibacter sp.	1872400	S	77	21	98	0.00001
Aestuariibacter sp. GS-14	2590670	S	45	10	55	0.00000
Aestuariibacter salexigens	226010	S	14	0	14	0.00000
Paraglaciecola chathamensis	368405	S	28	5	33	0.00000
Ningiella ruwaisensis	2364274	S	17	5	22	0.00000
Hydrocarboniclastica marina	2259620	S	13	2	15	0.00000
Neptunicella marina	2125989	S	12	2	14	0.00000
Pseudoalteromonas sp. MEBiC 03607	2563601	S	1948	5049	6997	0.00061
Pseudoalteromonas sp.	53249	S	311	1322	1633	0.00014
Pseudoalteromonas sp. 0303	2743618	S	276	2912	3188	0.00028
Pseudoalteromonas sp. '520P1 No. 423'	1690037	S	191	43	234	0.00002
Pseudoalteromonas sp. XI10	1766621	S	117	1234	1351	0.00012
Pseudoalteromonas sp. NBT06-2	2025950	S	65	5	70	0.00001
Pseudoalteromonas sp. HM-SA03	2029678	S	20	100	120	0.00001
Pseudoalteromonas sp. T1lg23B	2077097	S	17	10	27	0.00000
Pseudoalteromonas sp. P1-25	1723758	S	15	22	37	0.00000
Pseudoalteromonas shioyasakiensis	1190813	S	1750	14127	15877	0.00138
Pseudoalteromonas atlantica	288	S	1688	3469	5157	0.00045
Pseudoalteromonas arabiensis	874454	S	806	704	1510	0.00013
Pseudoalteromonas ruthenica	151081	S	496	114	610	0.00005
Pseudoalteromonas lipolytica	570156	S	250	701	951	0.00008
Pseudoalteromonas gelatinilytica	1703256	S	231	1097	1328	0.00012
Pseudoalteromonas tetraodonis	43659	S	227	979	1206	0.00011
Pseudoalteromonas undina	43660	S	57	261	318	0.00003
Pseudoalteromonas marina	267375	S	44	71	115	0.00001
Pseudoalteromonas nigrifaciens	28109	S	17	79	96	0.00001
Pseudoalteromonas distincta	77608	S	17	130	147	0.00001
Pseudoalteromonas espejiana	28107	S	15	22	37	0.00000
Algicola sp.	1872429	S	21	7	28	0.00000
Idiomarina baltica	190892	S	14541	14741	29282	0.00255
Idiomarina aquatica	1327752	S	1552	601	2153	0.00019
Idiomarina zobellii	86103	S	683	846	1529	0.00013
Idiomarina loihiensis	135577	S	426	213	639	0.00006
Idiomarina sp. MD25a	1889913	S	187	161	348	0.00003
Idiomarina sp. X4	2055892	S	62	72	134	0.00001
Idiomarina abyssalis	86102	S	218	109	327	0.00003
Idiomarina piscisalsi	1096243	S	199	173	372	0.00003
Idiomarina fontislapidosi	263723	S	78	20	98	0.00001
Idiomarinaceae bacterium	1898113	S	1653	1544	3197	0.00028
Pseudidiomarina aquimaris	641841	S	125	77	202	0.00002
Pseudidiomarina atlantica	1517416	S	14	7	21	0.00000
Litorilituus sediminis	718192	S	158	19	177	0.00002
Thalassotalea piscium	1230533	S	13	8	21	0.00000
Shewanella fidelis	173509	S	31	13	44	0.00000
Motilimonas pumila	2303987	S	16	7	23	0.00000
Marinobacter salsuginis	418719	S	194655	231296	425951	0.03712
Marinobacter nauticus	2743	S	31721	20754	52475	0.00457
Marinobacter sp.	50741	S	4676	4104	8780	0.00077
Marinobacter sp. B9-2	2137198	S	4329	17628	21957	0.00191
Marinobacter sp. EhC06	1849169	S	1402	2910	4312	0.00038
Marinobacter sp. NP-4(2019)	2488665	S	520	157	677	0.00006
Marinobacter sp. Arc7-DN-1	2304594	S	493	508	1001	0.00009
Marinobacter sp. es.042	1761794	S	414	1402	1816	0.00016
Marinobacter sp. LQ44	1749259	S	315	891	1206	0.00011
Marinobacter sp. BW6	2592624	S	312	286	598	0.00005
Marinobacter sp. es.048	1761795	S	101	65	166	0.00001
Marinobacter sp. JH2	2547598	S	46	34	80	0.00001
Marinobacter sp. F3R08	2841559	S	28	9	37	0.00000
Marinobacter sp. AC-23	1879031	S	22	4	26	0.00000
Marinobacter sp. R17	2484250	S	21	10	31	0.00000
Marinobacter sp. HL-58	1479237	S	16	3	19	0.00000
Marinobacter flavimaris	262076	S	4287	78717	83004	0.00723
Marinobacter manganoxydans	1150997	S	4015	71467	75482	0.00658
Marinobacter segnicrescens	430453	S	2316	1210	3526	0.00031
Marinobacter vinifirmus	355591	S	1481	2284	3765	0.00033
Marinobacter adhaerens	1033846	S	1116	10385	11501	0.00100
Marinobacter algicola	236100	S	919	1161	2080	0.00018
Marinobacter fuscus	2109942	S	908	1231	2139	0.00019
Marinobacter santoriniensis	523742	S	505	87	592	0.00005
Marinobacter oulmenensis	643747	S	409	65	474	0.00004
Marinobacter persicus	930118	S	318	292	610	0.00005
Marinobacter salarius	1420917	S	313	656	969	0.00008
Marinobacter litoralis	187981	S	283	66	349	0.00003
Marinobacter maroccanus	2055143	S	246	362	608	0.00005
Marinobacter aromaticivorans	1494078	S	233	78	311	0.00003
Marinobacter lipolyticus	209639	S	185	140	325	0.00003
Marinobacter shengliensis	1389223	S	138	241	379	0.00003
Marinobacter profundi	2666256	S	121	85	206	0.00002
Marinobacter denitrificans	2597703	S	56	64	120	0.00001
Marinobacter alexandrii	2570351	S	30	12	42	0.00000
Marinobacter antarcticus	564117	S	25	14	39	0.00000
Marinobacter pelagius	379482	S	22	14	36	0.00000
Marinobacter excellens	218670	S	19	28	47	0.00000
Marinobacter sediminum	256323	S	18	9	27	0.00000
Marinobacter lutaoensis	135739	S	18	5	23	0.00000
Marinobacter subterrani	1658765	S	16	6	22	0.00000
Marinobacter nitratireducens	1137280	S	12	1	13	0.00000
Halopseudomonas gallaeciensis	857227	S	35567	23682	59249	0.00516
Halopseudomonas pachastrellae	254161	S	3039	3370	6409	0.00056
Halopseudomonas aestusnigri	857252	S	3011	2007	5018	0.00044
Halopseudomonas oceani	1708783	S	738	520	1258	0.00011
Halopseudomonas sabulinigri	472181	S	191	36	227	0.00002
Halopseudomonas pelagia	553151	S	53	23	76	0.00001
Pseudomonas sp.	306	S	238	885	1123	0.00010
Pseudomonas sp. IC_126	2547400	S	33	16	49	0.00000
Pseudomonas sp. SSM44	2487347	S	23	23	46	0.00000
Pseudomonas sp. SST3	2267882	S	15	24	39	0.00000
Pseudomonas khazarica	2502979	S	94	62	156	0.00001
Pseudomonas chengduensis	489632	S	45	368	413	0.00004
Pseudomonas mendocina	300	S	28	45	73	0.00001
Pseudomonas benzenivorans	556533	S	26	26	52	0.00000
Pseudomonas saliphila	2586906	S	22	7	29	0.00000
Pseudomonas tohonis	2725477	S	12	12	24	0.00000
Stutzerimonas stutzeri	316	S	498	937	1435	0.00013
Stutzerimonas chloritidismutans	203192	S	16	372	388	0.00003
Stutzerimonas kunmingensis	1211807	S	16	265	281	0.00002
Pseudomonadaceae bacterium UBA836	1952795	S	122	110	232	0.00002
Pseudomonadaceae bacterium SI-3	2079806	S	15	20	35	0.00000
Pseudomonadales bacterium	1891229	S	773	183	956	0.00008
Gammaproteobacteria bacterium UBA2168	1948591	S	300	15	315	0.00003
Gammaproteobacteria bacterium	1913989	S	606278	140288	746566	0.06505
Gammaproteobacteria bacterium UBA7310	1948647	S	33047	10883	43930	0.00383
Gammaproteobacteria bacterium REDSEA-S15_B12	1811666	S	7700	5644	13344	0.00116
Gammaproteobacteria bacterium UBA6940	1948640	S	5168	841	6009	0.00052
gamma proteobacterium SCGC AAA007-O20	913327	S	2629	1382	4011	0.00035
gamma proteobacterium SCGC AB-629-P17	1131274	S	822	1030	1852	0.00016
Gammaproteobacteria bacterium UBA1119	1948582	S	668	403	1071	0.00009
Gammaproteobacteria bacterium UBA3532	1948611	S	581	325	906	0.00008
Gammaproteobacteria bacterium UBA7803	1948658	S	91	74	165	0.00001
Gammaproteobacteria bacterium UBA3498	1948609	S	49	8	57	0.00000
Gammaproteobacteria bacterium UBA1961	1948588	S	38	8	46	0.00000
Gammaproteobacteria bacterium UBA2675	1948596	S	34	147	181	0.00002
Acidiferrobacteraceae bacterium	2024893	S	420888	256233	677121	0.05900
Cobetia amphilecti	1055104	S	75451	55178	130629	0.01138
Cobetia crustatorum	553385	S	2615	2021	4636	0.00040
Cobetia marina	28258	S	823	561	1384	0.00012
Cobetia sp. L2A1	2686360	S	86	59	145	0.00001
Halomonas piezotolerans	2609667	S	14785	17148	31933	0.00278
Halomonas litopenaei	2109328	S	11326	9670	20996	0.00183
Halomonas meridiana	29570	S	8329	12126	20455	0.00178
Halomonas aquamarina	77097	S	3993	16488	20481	0.00178
Halomonas taeanensis	284577	S	3269	1289	4558	0.00040
Halomonas zincidurans	1178777	S	2621	1382	4003	0.00035
Halomonas salina	42565	S	2157	3559	5716	0.00050
Halomonas sp.	1486246	S	535	277	812	0.00007
Halomonas sp. UBA3074	1946584	S	394	525	919	0.00008
Halomonas sp. A40-4	2785909	S	173	189	362	0.00003
Halomonas sp. 54_146	1635257	S	38	33	71	0.00001
Halomonas sp. JSM 104105	1562110	S	17	16	33	0.00000
Halomonas sp. FME66	2742615	S	16	23	39	0.00000
Halomonas sp. KAO	2783858	S	12	15	27	0.00000
Halomonas lionensis	1144478	S	1058	3433	4491	0.00039
Halomonas salicampi	1449798	S	197	65	262	0.00002
Halomonas hamiltonii	502829	S	117	349	466	0.00004
Halomonas cupida	44933	S	85	10	95	0.00001
Halomonas lutescens	1602943	S	77	31	108	0.00001
Halomonas alkaliantarctica	232346	S	56	76	132	0.00001
Halomonas sulfidaeris	115553	S	55	18	73	0.00001
Halomonas sedimenti	2729618	S	36	62	98	0.00001
Halomonas ventosae	229007	S	33	41	74	0.00001
Halomonas xianhensis	442341	S	26	9	35	0.00000
Halomonas stevensii	502821	S	26	103	129	0.00001
Halomonas campaniensis	213554	S	22	33	55	0.00000
Halomonas maris	2729617	S	17	49	66	0.00001
Halomonas gudaonensis	376427	S	16	21	37	0.00000
Chromohalobacter israelensis	141390	S	10011	10404	20415	0.00178
Chromohalobacter salexigens	158080	S	47	69	116	0.00001
Chromohalobacter japonicus	223900	S	41	82	123	0.00001
Chromohalobacter marismortui	42055	S	27	8	35	0.00000
Chromohalobacter canadensis	141389	S	14	13	27	0.00000
Salinicola salarius	430457	S	1737	1246	2983	0.00026
Salinicola sp.	1978524	S	63	127	190	0.00002
Salinicola peritrichatus	1267424	S	46	26	72	0.00001
Kushneria konosiri	698828	S	993	1026	2019	0.00018
Kushneria marisflavi	157779	S	49	51	100	0.00001
Modicisalibacter sp. 'Wilcox'	2679914	S	248	1306	1554	0.00014
Halomonadaceae bacterium T82-2	1783518	S	130	738	868	0.00008
Carnimonas nigrificans	64323	S	28	3	31	0.00000
Oceanospirillaceae bacterium	1899355	S	47221	11453	58674	0.00511
Thalassolituus sp. UBA1087	1947651	S	9874	1084	10958	0.00095
Thalassolituus sp. UBA674	1947666	S	2541	821	3362	0.00029
Thalassolituus sp. UBA2107	1947659	S	654	1157	1811	0.00016
Thalassolituus sp. C2-1	2597518	S	13	4	17	0.00000
Marinobacterium litorale	404770	S	3971	1127	5098	0.00044
Marinobacterium iners	48076	S	80	8	88	0.00001
Marinobacterium sp. A346	2851016	S	17	9	26	0.00000
Neptuniibacter sp. UBA6509	1946976	S	333	53	386	0.00003
Neptuniibacter marinus	1806670	S	21	10	31	0.00000
Marinomonas piezotolerans	2213058	S	105	52	157	0.00001
Marinomonas profundimaris	1208321	S	14	39	53	0.00000
Oleibacter marinus	484498	S	84	99	183	0.00002
Maribrevibacterium harenarium	2589817	S	13	8	21	0.00000
Alloalcanivorax venustensis	172371	S	3944	13304	17248	0.00150
Alloalcanivorax profundimaris	2735259	S	3379	4060	7439	0.00065
Alloalcanivorax marinus	1177169	S	546	378	924	0.00008
Alloalcanivorax gelatiniphagus	1194167	S	412	349	761	0.00007
Alloalcanivorax mobilis	2019569	S	43	11	54	0.00000
Alloalcanivorax dieselolei	285091	S	24	21	45	0.00000
Alcanivorax sp. DSM 26293	1798238	S	2089	2562	4651	0.00041
Alcanivorax sp.	1872427	S	2087	1628	3715	0.00032
Alcanivorax sp. UBA4485	1945988	S	389	482	871	0.00008
Alcanivorax sp. DG881	236097	S	12	11	23	0.00000
Alcanivorax profundi	2338368	S	423	1572	1995	0.00017
Alcanivorax nanhaiticus	1177154	S	53	59	112	0.00001
Alcanivorax jadensis	64988	S	51	31	82	0.00001
Alcanivorax hongdengensis	519051	S	30	15	45	0.00000
Alcanivoracaceae bacterium	2024895	S	217	280	497	0.00004
Ketobacter sp.	2083498	S	46	8	54	0.00000
Ketobacter sp. MCCC 1A13808	2602738	S	26	7	33	0.00000
Ketobacter alkanivorans	1917421	S	52	29	81	0.00001
Isoalcanivorax pacificus	1306787	S	14	12	26	0.00000
Endozoicomonas sp. G2_2	2821092	S	161	131	292	0.00003
Hahellaceae bacterium	2048971	S	55	5	60	0.00001
Oleiphilus sp.	2025907	S	42	3	45	0.00000
Spongiibacter tropicus	454602	S	22197	11771	33968	0.00296
Spongiibacter marinus	354246	S	688	466	1154	0.00010
Spongiibacter sp. IMCC21906	1620392	S	92	43	135	0.00001
Spongiibacter pelagi	2760804	S	22	16	38	0.00000
Spongiibacteraceae bacterium UBA5047	1953081	S	15	7	22	0.00000
Zhongshania aliphaticivorans	1470434	S	16	5	21	0.00000
Halioglobus japonicus	930805	S	128	5	133	0.00001
Halioglobus sp.	2024834	S	105	34	139	0.00001
Halioglobus pacificus	930806	S	92	6	98	0.00001
Haliea sp.	1932666	S	254	22	276	0.00002
Haliea salexigens	287487	S	15	24	39	0.00000
Halieaceae bacterium	2026743	S	22	5	27	0.00000
Halieaceae bacterium UBA5085	1951918	S	16	17	33	0.00000
Sediminihaliea albiluteola	2758564	S	43	5	48	0.00000
Porticoccus hydrocarbonoclasticus	1073414	S	89	148	237	0.00002
Porticoccus sp.	2024853	S	25	16	41	0.00000
Porticoccaceae bacterium UBA1117	1952748	S	80	7	87	0.00001
SAR92 bacterium BACL16 MAG-120619-bin48	1655625	S	28	17	45	0.00000
uncultured SAR92 cluster bacterium	1118066	S	15	3	18	0.00000
Porticoccaceae bacterium	2026782	S	44	14	58	0.00001
Cellvibrionales bacterium UBA2511	1950788	S	16	11	27	0.00000
Chromatiales bacterium	2026725	S	9345	731	10076	0.00088
Woeseiaceae bacterium	2026806	S	2964	1719	4683	0.00041
uncultured Woeseiaceae bacterium	1983305	S	28	2	30	0.00000
Rheinheimera aquimaris	412437	S	210	65	275	0.00002
Arsukibacterium sp. UBA3155	1946058	S	22	3	25	0.00000
Thiohalocapsa marina	424902	S	13	2	15	0.00000
Oceanococcus atlanticus	1317117	S	45	1	46	0.00000
Ectothiorhodospiraceae bacterium	2026737	S	17	1	18	0.00000
Salinisphaera sp. UBA1666	1947454	S	5074	1577	6651	0.00058
Salinisphaera sp. UBA6602	1947455	S	420	251	671	0.00006
Salinisphaera sp.	1914330	S	217	90	307	0.00003
Salinisphaera shabanensis	180542	S	1250	389	1639	0.00014
Salinisphaera japonica	1304270	S	726	437	1163	0.00010
Salinisphaera hydrothermalis	563188	S	45	5	50	0.00000
Salinisphaera orenii	856731	S	17	28	45	0.00000
Salinisphaera halophila	1304158	S	12	22	34	0.00000
Abyssibacter profundi	2182787	S	326	58	384	0.00003
uncultured SAR86 cluster bacterium	648174	S	3846	892	4738	0.00041
SAR86 cluster bacterium REDSEA-S09_B4	1811643	S	375	18	393	0.00003
SAR86 cluster bacterium SAR86A	1123866	S	55	40	95	0.00001
Candidatus Thioglobus sp. MED-G25	1986229	S	1841	664	2505	0.00022
Candidatus Thioglobus sp.	2026721	S	138	92	230	0.00002
uncultured Candidatus Thioglobus sp.	655186	S	41	46	87	0.00001
Candidatus Thioglobus perditus	2058498	S	30	3	33	0.00000
Candidatus Thioglobus autotrophicus	1705394	S	23	2	25	0.00000
K189A clade bacterium	2315472	S	27	10	37	0.00000
marine gamma proteobacterium HTCC2089	247632	S	24	0	24	0.00000
uncultured OM182 clade bacterium	1128416	S	18	2	20	0.00000
Pseudohongiella nitratireducens	1768907	S	19	11	30	0.00000
Vibrio campbellii	680	S	975	1871	2846	0.00025
Vibrio mytili	50718	S	34	45	79	0.00001
Vibrio sp. AND4	314289	S	15	5	20	0.00000
Vibrio chagasii	170679	S	61	388	449	0.00004
Vibrio sp. HI00D65	1822216	S	39	193	232	0.00002
Vibrio penaeicida	104609	S	13	3	16	0.00000
Photobacterium angustum	661	S	174	744	918	0.00008
Photobacterium leiognathi	553611	S	137	454	591	0.00005
Photobacterium sp. GB-56	2022106	S	23	87	110	0.00001
Photobacterium lucens	2562949	S	15	45	60	0.00001
Enterovibrio pacificus	1080227	S	112	14	126	0.00001
Paraphotobacterium marinum	1755811	S	103	28	131	0.00001
Veronia nyctiphanis	1278244	S	29	4	33	0.00000
Psychrobacter submarinus	154108	S	1507	1273	2780	0.00024
Psychrobacter sp. bablab_jr014	2755139	S	69	27	96	0.00001
Psychrobacter celer	306572	S	72	59	131	0.00001
Psychrobacter pacificensis	112002	S	72	220	292	0.00003
Psychrobacter piscatorii	554343	S	14	24	38	0.00000
Acinetobacter venetianus	52133	S	1163	1004	2167	0.00019
Acinetobacter junii	40215	S	16	48	64	0.00001
Acinetobacter ihumii	2483802	S	14	21	35	0.00000
Methylophaga sp.	2024840	S	2169	665	2834	0.00025
Methylophaga sp. UBA2689	1946878	S	12	20	32	0.00000
Methylophaga aminisulfidivorans	230105	S	82	78	160	0.00001
Cycloclasticus sp.	2024830	S	52	15	67	0.00001
uncultured Francisellaceae bacterium	393692	S	270	3	273	0.00002
Thiotrichales bacterium	2026796	S	123	16	139	0.00001
Cysteiniphilum litorale	2056700	S	15	9	24	0.00000
uncultured Thiothrix sp.	223185	S	15	1	16	0.00000
Xanthomonadales bacterium	2006849	S	3306	475	3781	0.00033
Legionellales bacterium	2026754	S	1037	120	1157	0.00010
Legionella sp.	459	S	859	44	903	0.00008
Legionella rowbothamii	96229	S	29	5	34	0.00000
Coxiellaceae bacterium	2026727	S	32	1	33	0.00000
uncultured Gammaproteobacteria bacterium	86473	S	1686	309	1995	0.00017
Methylococcales bacterium OPU3_GD_OMZ	1920888	S	930	125	1055	0.00009
Methylococcaceae bacterium UBA1147	1952219	S	167	23	190	0.00002
Providencia huaxiensis	2027290	S	69	47	116	0.00001
Providencia rettgeri	587	S	37	29	66	0.00001
Polycyclovorans sp.	2024852	S	15	20	35	0.00000
Pelagibacteraceae bacterium	2026775	S	128275	113858	242133	0.02110
alpha proteobacterium SCGC AAA288-G21	939324	S	4579	10367	14946	0.00130
Pelagibacteraceae bacterium AG-464-P07	2162008	S	1395	1970	3365	0.00029
alpha proteobacterium SCGC AAA288-E13	939316	S	1381	6351	7732	0.00067
alpha proteobacterium SCGC AAA240-E13	939306	S	862	2690	3552	0.00031
alpha proteobacterium SCGC AAA288-N07	939346	S	377	723	1100	0.00010
Pelagibacteraceae bacterium AG-439-F23	2162002	S	106	185	291	0.00003
Pelagibacteraceae bacterium AG-464-B04	2162007	S	67	38	105	0.00001
Pelagibacteraceae bacterium AG-404-N13	2161987	S	53	99	152	0.00001
Pelagibacteraceae bacterium AG-319-F18	2162057	S	25	297	322	0.00003
Pelagibacteraceae bacterium AG-410-D23	2162050	S	21	36	57	0.00000
Candidatus Pelagibacter sp.	2024849	S	41848	57242	99090	0.00863
uncultured Candidatus Pelagibacter sp.	372654	S	97	73	170	0.00001
Candidatus Pelagibacter ubique	198252	S	39	524	563	0.00005
uncultured Pelagibacteraceae bacterium	1667051	S	28122	96123	124245	0.01083
Pelagibacterales bacterium	2026776	S	585	647	1232	0.00011
Pelagibacterales bacterium SAG-MED01	2760004	S	16	39	55	0.00000
Rhodospirillaceae bacterium	1898112	S	154068	30549	184617	0.01609
Rhodospirillaceae bacterium UBA2165	1952852	S	1765	85	1850	0.00016
Rhodospirillaceae bacterium UBA6608	1952863	S	127	26	153	0.00001
Rhodospirillaceae bacterium UBA3470	1952854	S	55	13	68	0.00001
Rhodospirillaceae bacterium UBA1479	1952849	S	41	6	47	0.00000
Rhodospirillaceae bacterium TMED167	1986863	S	15	12	27	0.00000
Hwanghaeella grinnelliae	2500179	S	50	0	50	0.00000
Rhodospirillales bacterium	2026786	S	3729	760	4489	0.00039
Thalassospira sp. MCCC 1A01148	501834	S	959	1248	2207	0.00019
Thalassospira sp. MCCC 1A01428	1470575	S	70	44	114	0.00001
Thalassospira povalilytica	732237	S	195	118	313	0.00003
Thalassospira xiamenensis	220697	S	23	107	130	0.00001
Thalassospira indica	1891279	S	20	142	162	0.00001
Thalassospira profundimaris	502049	S	12	8	20	0.00000
Magnetovibrio sp.	2024836	S	36	4	40	0.00000
Nisaea denitrificans	390877	S	17	29	46	0.00000
Nisaea nitritireducens	568392	S	12	20	32	0.00000
Tistrella mobilis	171437	S	37	8	45	0.00000
Alphaproteobacteria bacterium MarineAlpha5_Bin3	2013078	S	35124	2509	37633	0.00328
Alphaproteobacteria bacterium UBA7887	1948447	S	33183	6957	40140	0.00350
Alphaproteobacteria bacterium MarineAlpha3_Bin6	2013072	S	1657	158	1815	0.00016
Alphaproteobacteria bacterium	1913988	S	933	274	1207	0.00011
Alphaproteobacteria bacterium MarineAlpha9_Bin7	2013102	S	527	51	578	0.00005
Alphaproteobacteria bacterium MarineAlpha3_Bin3	2013069	S	473	150	623	0.00005
Alphaproteobacteria bacterium MarineAlpha3_Bin4	2013070	S	385	16	401	0.00003
Alphaproteobacteria bacterium MarineAlpha3_Bin2	2013068	S	121	13	134	0.00001
Alphaproteobacteria bacterium MarineAlpha9_Bin6	2013101	S	107	1	108	0.00001
Alphaproteobacteria bacterium MarineAlpha3_Bin7	2013073	S	105	5	110	0.00001
Alphaproteobacteria bacterium MarineAlpha6_Bin2	2013089	S	45	2	47	0.00000
Alphaproteobacteria bacterium UBA3002	1948380	S	42	1	43	0.00000
Alphaproteobacteria bacterium UBA6544	1948430	S	34	8	42	0.00000
Alphaproteobacteria bacterium MarineAlpha10_Bin2	2013104	S	31	1	32	0.00000
Alphaproteobacteria bacterium MarineAlpha5_Bin12	2013087	S	28	13	41	0.00000
Alphaproteobacteria bacterium UBA828	1948450	S	27	0	27	0.00000
Alphaproteobacteria bacterium MarineAlpha9_Bin1	2013096	S	26	1	27	0.00000
Alphaproteobacteria bacterium MarineAlpha5_Bin5	2013080	S	22	2	24	0.00000
Alphaproteobacteria bacterium MarineAlpha11_Bin1	2013106	S	16	32	48	0.00000
Alphaproteobacteria bacterium MarineAlpha9_Bin3	2013098	S	14	4	18	0.00000
Alphaproteobacteria bacterium UBA7314	1948440	S	14	0	14	0.00000
Alphaproteobacteria bacterium MarineAlpha5_Bin7	2013082	S	14	0	14	0.00000
Albimonas donghaensis	356660	S	10914	3378	14292	0.00125
Albimonas pacifica	1114924	S	6110	2690	8800	0.00077
Tritonibacter mobilis	379347	S	5035	3925	8960	0.00078
Tritonibacter scottomollicae	483013	S	46	24	70	0.00001
Tritonibacter horizontis	1768241	S	13	17	30	0.00000
Paracoccaceae bacterium	1904441	S	4790	1502	6292	0.00055
Paracoccus sp. UBA889	1947056	S	922	558	1480	0.00013
Paracoccus sp. R12_2	2821098	S	194	172	366	0.00003
Paracoccus halophilus	376733	S	21	20	41	0.00000
Paracoccus sediminilitoris	2202419	S	15	10	25	0.00000
Thioclava sp. JE_KL1	2651187	S	12	244	256	0.00002
Thioclava sediminum	1915319	S	20	450	470	0.00004
Thioclava atlantica	1317124	S	17	39	56	0.00000
Thioclava electrotropha	1549850	S	15	344	359	0.00003
Pseudooceanicola atlanticus	1461694	S	287	591	878	0.00008
Pseudooceanicola lipolyticus	2029104	S	257	523	780	0.00007
Pseudooceanicola nanhaiensis	375761	S	51	80	131	0.00001
Pseudooceanicola marinus	396013	S	37	16	53	0.00000
Vannielia litorea	1217970	S	513	340	853	0.00007
Allosediminivita pacifica	1267769	S	376	538	914	0.00008
Arenibacterium halophilum	2583821	S	373	145	518	0.00005
Marinibacterium profundimaris	1679460	S	354	690	1044	0.00009
Pacificitalea manganoxidans	1411902	S	235	87	322	0.00003
Alterinioella nitratireducens	2735915	S	99	61	160	0.00001
Thalassobium sp.	2030825	S	72	36	108	0.00001
Limimaricola cinnabarinus	1125964	S	53	40	93	0.00001
Marivivens sp.	1978374	S	30	21	51	0.00000
Cognatiyoonia sediminum	1508389	S	25	2	27	0.00000
Rhodovulum sp.	34009	S	15	5	20	0.00000
Pelagivirga sediminicola	2170575	S	13	19	32	0.00000
Roseovarius mucosus	215743	S	2011	2917	4928	0.00043
Roseovarius atlanticus	1641875	S	357	535	892	0.00008
Roseovarius halotolerans	505353	S	351	578	929	0.00008
Roseovarius indicus	540747	S	319	75	394	0.00003
Roseovarius sp.	1486281	S	239	198	437	0.00004
Roseovarius sp. MCTG156(2b)	1354722	S	15	19	34	0.00000
Roseovarius nubinhibens	314263	S	191	121	312	0.00003
Roseovarius pacificus	337701	S	168	135	303	0.00003
Roseovarius nitratireducens	2044597	S	28	25	53	0.00000
Salipiger profundus	1229727	S	2847	3225	6072	0.00053
Salipiger bermudensis	344736	S	1057	1193	2250	0.00020
Salipiger marinus	555512	S	563	617	1180	0.00010
Salipiger thiooxidans	282683	S	174	223	397	0.00003
Salipiger pallidus	1775170	S	61	49	110	0.00001
Sulfitobacter sp. R18_2	2821105	S	688	1780	2468	0.00022
Sulfitobacter sp. HI0040	1822232	S	279	343	622	0.00005
Sulfitobacter sp. BDSS02	2663018	S	190	351	541	0.00005
Sulfitobacter sp. D7	1968541	S	99	518	617	0.00005
Sulfitobacter sp.	1903071	S	80	191	271	0.00002
Sulfitobacter pontiacus	60137	S	631	1072	1703	0.00015
Sulfitobacter delicatus	218672	S	25	48	73	0.00001
Sulfitobacter litoralis	335975	S	19	85	104	0.00001
Sulfitobacter dubius	218673	S	18	32	50	0.00000
Actibacterium naphthalenivorans	1614693	S	1270	2421	3691	0.00032
Maritimibacter sp.	2003363	S	926	443	1369	0.00012
Maritimibacter sp. REDSEA-S28_B5	1811547	S	17	27	44	0.00000
Thalassobius sp.	1979401	S	914	346	1260	0.00011
Phaeobacter sp. 22II1-1F12B	1317111	S	434	790	1224	0.00011
Phaeobacter sp. CECT 5382	1712645	S	17	4	21	0.00000
Phaeobacter gallaeciensis	60890	S	253	88	341	0.00003
Roseobacter sp.	1907202	S	428	170	598	0.00005
Roseobacter sp. MED193	314262	S	45	54	99	0.00001
Thiosulfatihalobacter marinus	2792481	S	344	483	827	0.00007
Maribius pelagius	387096	S	100	170	270	0.00002
Sagittula sp. P11	2009329	S	140	71	211	0.00002
Yangia pacifica	311180	S	106	76	182	0.00002
Lutimaribacter saemankumensis	490829	S	116	43	159	0.00001
Celeribacter persicus	1651082	S	42	92	134	0.00001
Roseivivax marinus	1379903	S	35	24	59	0.00001
Tranquillimonas alkanivorans	441119	S	43	10	53	0.00000
Dinoroseobacter sp.	2003366	S	18	0	18	0.00000
Roseicyclus sp.	1914329	S	17	5	22	0.00000
Oceanicola sp. 22II-s10i	1317116	S	16	25	41	0.00000
uncultured Tateyamaria sp.	455651	S	14	0	14	0.00000
Erythrobacter sp. A30-3	2785907	S	8766	10037	18803	0.00164
Erythrobacter sp.	1042	S	3162	1877	5039	0.00044
Erythrobacter sp. HI0063	1822240	S	870	854	1724	0.00015
Erythrobacter sp. 3-20A1M	2653850	S	52	37	89	0.00001
Erythrobacter sp. UBA2510	1946470	S	50	84	134	0.00001
Erythrobacter sp. SD-21	161528	S	12	5	17	0.00000
Erythrobacter aureus	2182384	S	1557	524	2081	0.00018
Erythrobacter longus	1044	S	38	4	42	0.00000
Erythrobacter litoralis	39960	S	28	26	54	0.00000
Qipengyuania flava	192812	S	2123	624	2747	0.00024
Qipengyuania citrea	225971	S	947	958	1905	0.00017
Qipengyuania pelagi	994320	S	114	108	222	0.00002
Qipengyuania vulgaris	291985	S	68	38	106	0.00001
Croceicoccus sp.	1927144	S	211	424	635	0.00006
Aurantiacibacter zhengii	2307003	S	81	62	143	0.00001
Aurantiacibacter atlanticus	1648404	S	24	4	28	0.00000
Erythrobacteraceae bacterium	2026738	S	108	9	117	0.00001
Actirhodobacter atriluteus	2744473	S	38	16	54	0.00000
Pseudopontixanthobacter vadosimaris	2726450	S	30	16	46	0.00000
Croceibacterium atlanticum	1267766	S	12	7	19	0.00000
Citromicrobium sp.	2024827	S	3163	1816	4979	0.00043
Citromicrobium sp. UBA3494	1946345	S	113	186	299	0.00003
Citromicrobium sp. JLT1363	517722	S	66	110	176	0.00002
Citromicrobium bathyomarinum	72174	S	193	181	374	0.00003
Novosphingopyxis iocasae	2762729	S	3288	1778	5066	0.00044
Novosphingopyxis baekryungensis	279369	S	53	9	62	0.00001
Sphingomonas sp. SKA58	314266	S	2940	4642	7582	0.00066
Sphingomonas sp.	28214	S	110	36	146	0.00001
Sphingomonas abaci	237611	S	146	191	337	0.00003
Sphingomonas ginsenosidimutans	862134	S	12	19	31	0.00000
Sphingobium xenophagum	121428	S	859	1735	2594	0.00023
Sphingobium sp. TCM1	453246	S	354	581	935	0.00008
Sphingobium sp.	1912891	S	52	38	90	0.00001
Sphingobium sp. CCH11-B1	1768781	S	22	70	92	0.00001
Sphingobium sp. OAE613	2663803	S	15	5	20	0.00000
Sphingobium yanoikuyae	13690	S	112	359	471	0.00004
Sphingobium lactosutens	522773	S	27	125	152	0.00001
Sphingobium algorifonticola	2008318	S	24	17	41	0.00000
Novosphingobium indicum	462949	S	455	346	801	0.00007
Novosphingobium aquimarinum	2682494	S	34	46	80	0.00001
Novosphingobium panipatense	428991	S	30	36	66	0.00001
Novosphingobium mathurense	428990	S	24	7	31	0.00000
Novosphingobium silvae	2692619	S	16	29	45	0.00000
Novosphingobium marinum	1514948	S	16	12	28	0.00000
Novosphingobium pentaromativorans	205844	S	15	11	26	0.00000
Novosphingobium barchaimii	1420591	S	15	17	32	0.00000
Stakelama pacifica	517720	S	212	162	374	0.00003
Sphingopyxis sp.	1908224	S	51	34	85	0.00001
Rhizorhabdus sp.	1968843	S	44	72	116	0.00001
uncultured Parasphingopyxis sp.	1547918	S	49	83	132	0.00001
Sphingomonadaceae bacterium MED-G03	1986231	S	25	11	36	0.00000
Sphingosinithalassobacter portus	2676234	S	16	5	21	0.00000
Sphingomonadales bacterium	1978525	S	76	30	106	0.00001
Pacificimonas flava	1234595	S	74	43	117	0.00001
Roseibium aggregatum	187304	S	15813	6097	21910	0.00191
Stappia indica	538381	S	579	595	1174	0.00010
Stappia sp.	1870903	S	423	291	714	0.00006
Stappia sp. BW2	2592622	S	84	71	155	0.00001
Parvibaculum indicum	562969	S	4391	4525	8916	0.00078
Parvibaculum sp.	2024848	S	196	85	281	0.00002
Rhodobiaceae bacterium	2026785	S	5078	1553	6631	0.00058
Rhodobiaceae bacterium UBA7804	1952834	S	250	169	419	0.00004
Ahrensia sp.	1872419	S	3785	2583	6368	0.00055
Hoeflea sp.	1940281	S	1372	981	2353	0.00021
Nitratireductor sp.	1872084	S	665	209	874	0.00008
Nitratireductor aquibiodomus	204799	S	25	12	37	0.00000
Nitratireductor indicus	721133	S	18	17	35	0.00000
Phyllobacteriaceae bacterium	1871068	S	674	209	883	0.00008
Mesorhizobium sediminum	1849104	S	16	14	30	0.00000
Fulvimarina manganoxydans	937218	S	789	66	855	0.00007
Fulvimarina sp.	1969479	S	315	368	683	0.00006
Aurantimonas coralicida	182270	S	149	657	806	0.00007
Martelella mediterranea	293089	S	330	186	516	0.00004
Martelella sp. AD-3	686597	S	96	127	223	0.00002
Jiella pacifica	2696469	S	63	31	94	0.00001
Methylobacterium fujisawaense	107400	S	656	810	1466	0.00013
Filomicrobium sp.	2024831	S	648	52	700	0.00006
Methyloceanibacter sp.	1965321	S	320	43	363	0.00003
Hyphomicrobiales bacterium	1909294	S	913	278	1191	0.00010
Rhizobiales bacterium CCH10-E5	1768797	S	18	15	33	0.00000
Afipia sp. OHSU_II-C1	1297860	S	21	38	59	0.00001
Bradyrhizobiaceae bacterium PARB1	2015576	S	28	22	50	0.00000
Acuticoccus yangtzensis	1443441	S	87	9	96	0.00001
Rhizobiaceae bacterium	1913961	S	57	9	66	0.00001
Rickettsiales bacterium	2026788	S	22226	6027	28253	0.00246
Hyphomonas sp.	87	S	1855	1450	3305	0.00029
Hyphomonas sp. L-53-1-40	1207058	S	911	415	1326	0.00012
Hyphomonas sp. CY54-11-8	1280944	S	178	195	373	0.00003
Hyphomonas sp. UBA5111	1946637	S	78	105	183	0.00002
Hyphomonas adhaerens	81029	S	1705	493	2198	0.00019
Hyphomonas atlantica	1280948	S	705	936	1641	0.00014
Hyphomonas pacifica	1280941	S	412	1005	1417	0.00012
Ponticaulis sp.	2020902	S	2558	638	3196	0.00028
Hyphomonadaceae bacterium TMED5	1986776	S	2441	1527	3968	0.00035
Hyphomonadaceae bacterium UBA5336	1951953	S	18	9	27	0.00000
Hyphomonadaceae bacterium UBA1849	1951945	S	15	9	24	0.00000
Hirschia sp.	2024835	S	1553	207	1760	0.00015
Henriciella sp.	1968823	S	1215	536	1751	0.00015
Henriciella algicola	1608422	S	27	7	34	0.00000
Henriciella aquimarina	545261	S	26	33	59	0.00001
Oceanicaulis sp. HTCC2633	314254	S	11960	5742	17702	0.00154
Oceanicaulis sp. PT13A	2135616	S	280	78	358	0.00003
Maricaulis sp.	1486257	S	261	72	333	0.00003
Maricaulis maris	74318	S	99	28	127	0.00001
Maricaulis alexandrii	2570354	S	45	16	61	0.00001
uncultured Alphaproteobacteria bacterium	91750	S	8999	3570	12569	0.00110
Parvularcula sp.	1979207	S	1203	578	1781	0.00016
Marinicaulis flavus	2058213	S	21	2	23	0.00000
uncultured SAR116 cluster alpha proteobacterium	281031	S	238	184	422	0.00004
SAR116 cluster bacterium	2024888	S	54	72	126	0.00001
OCS116 cluster bacterium AG-435-F03	2162589	S	21	105	126	0.00001
Magnetococcales bacterium	2026759	S	207	2	209	0.00002
Caulobacteraceae bacterium UBA3198	1951537	S	101	27	128	0.00001
Caulobacter sp. CCH9-E1	1768768	S	12	23	35	0.00000
Kordiimonas sp.	1970157	S	27	16	43	0.00000
Kordiimonas pumila	2161677	S	19	0	19	0.00000
Luteithermobacter gelatinilyticus	2582913	S	18	1	19	0.00000
Pseudomonadota bacterium	1977087	S	38432	11221	49653	0.00433
Proteobacteria bacterium UBA5680	1948185	S	31300	5287	36587	0.00319
Proteobacteria bacterium UBA1148	1948131	S	1506	244	1750	0.00015
Proteobacteria bacterium UBA2133	1948144	S	1395	40	1435	0.00013
Proteobacteria bacterium UBA2996	1948156	S	218	130	348	0.00003
Proteobacteria bacterium UBA6503	1948193	S	89	11	100	0.00001
Proteobacteria bacterium UBA1673	1948137	S	12	0	12	0.00000
Limnobacter sp. SAORIC-580	2732163	S	2436	4710	7146	0.00062
Limnobacter sp. MED105	391597	S	157	184	341	0.00003
Limnobacter sp. CACIAM 66H1	1813033	S	58	93	151	0.00001
Cupriavidus pauculus	82633	S	2838	1981	4819	0.00042
Cupriavidus campinensis	151783	S	145	84	229	0.00002
Burkholderia aenigmatica	2015348	S	12	9	21	0.00000
Variovorax paradoxus	34073	S	235	719	954	0.00008
Delftia acidovorans	80866	S	25	91	116	0.00001
Curvibacter sp.	1888168	S	43	51	94	0.00001
Comamonadaceae bacterium ALPHA2B	2502232	S	16	116	132	0.00001
Pusillimonas sp. UBA3987	1947369	S	74	56	130	0.00001
Pusillimonas maritima	2026239	S	26	51	77	0.00001
Pelistega indica	1414851	S	18	3	21	0.00000
Herbaspirillum huttiense	863372	S	32	46	78	0.00001
uncultured Burkholderiales bacterium	208544	S	31	15	46	0.00000
Burkholderiales bacterium	1891238	S	23	17	40	0.00000
Nitrosomonadaceae bacterium	2026767	S	37	4	41	0.00000
Methylophilus sp.	29541	S	28	7	35	0.00000
Methyloversatilis discipulorum	1119528	S	22	9	31	0.00000
Candidatus Lambdaproteobacteria bacterium	2035771	S	329	29	358	0.00003
uncultured proteobacterium	153809	S	23	3	26	0.00000
Candidatus Marinimicrobia bacterium	2026760	S	1356937	223490	1580427	0.13772
Candidatus Marinimicrobia bacterium UBA7300	1953254	S	344393	209848	554241	0.04830
Candidatus Marinimicrobia bacterium UBA6531	1953244	S	271477	177627	449104	0.03913
Candidatus Marinimicrobia bacterium UBA2125	1953217	S	128125	205969	334094	0.02911
Candidatus Marinimicrobia bacterium UBA7303	1953256	S	20468	7826	28294	0.00247
Candidatus Marinimicrobia bacterium UBA7301	1953255	S	9474	1918	11392	0.00099
Candidatus Marinimicrobia bacterium UBA1611	1953216	S	5195	2876	8071	0.00070
Candidatus Marinimicrobia bacterium 408169	1958814	S	2635	357	2992	0.00026
Candidatus Marinimicrobia bacterium UBA7308	1953257	S	1291	102	1393	0.00012
uncultured Candidatus Marinimicrobia bacterium	195045	S	338	132	470	0.00004
Candidatus Marinimicrobia bacterium UBA6931	1953249	S	258	19	277	0.00002
Candidatus Marinimicrobia bacterium UBA1134	1953213	S	208	60	268	0.00002
Marinimicrobia bacterium TCS55	1781246	S	188	26	214	0.00002
Candidatus Marinimicrobia bacterium REDSEA-S14_B6	1811603	S	166	25	191	0.00002
Marinimicrobia bacterium SCGC AAA003-L08	939844	S	96	0	96	0.00001
Candidatus Marinimicrobia bacterium UBA2986	1953231	S	24	1	25	0.00000
Candidatus Marinimicrobia bacterium UBA2980	1953230	S	18	4	22	0.00000
Zunongwangia profunda	398743	S	13782	15680	29462	0.00257
Zunongwangia mangrovi	1334022	S	13214	8726	21940	0.00191
Zunongwangia atlantica	1502297	S	1970	1523	3493	0.00030
Flavobacteriaceae bacterium	1871037	S	37803	9061	46864	0.00408
Flavobacteriaceae bacterium UBA4166	1951841	S	709	13	722	0.00006
Flavobacteriaceae bacterium UBA3611	1951834	S	39	12	51	0.00000
Muricauda sediminis	2696468	S	2317	1782	4099	0.00036
Muricauda oceanensis	2499163	S	2015	1420	3435	0.00030
Muricauda ruestringensis	111501	S	1198	828	2026	0.00018
Muricauda sp. ARW1Y1	2663843	S	598	142	740	0.00006
Muricauda sp.	192149	S	266	177	443	0.00004
Muricauda sp. MAR_2010_75	1250232	S	45	24	69	0.00001
Muricauda sp. TMED12	1986608	S	20	14	34	0.00000
Muricauda sp. CP2A	1848189	S	18	10	28	0.00000
Muricauda hadalis	2597517	S	241	142	383	0.00003
Muricauda lutaonensis	516051	S	158	19	177	0.00002
Muricauda maritima	2306998	S	110	158	268	0.00002
Muricauda aequoris	2306997	S	85	67	152	0.00001
Muricauda amoyensis	2169401	S	24	6	30	0.00000
Muricauda oceani	2698672	S	21	20	41	0.00000
Muricauda lutimaris	475082	S	15	9	24	0.00000
Muricauda zhangzhouensis	1073328	S	15	2	17	0.00000
Muricauda brasiliensis	2162892	S	12	3	15	0.00000
Winogradskyella sp.	1883156	S	7057	1710	8767	0.00076
Leeuwenhoekiella palythoae	573501	S	2338	702	3040	0.00026
Leeuwenhoekiella blandensis	360293	S	2003	964	2967	0.00026
Leeuwenhoekiella sp.	1977054	S	292	90	382	0.00003
Leeuwenhoekiella nanhaiensis	1655491	S	33	17	50	0.00000
Leeuwenhoekiella polynyae	1550906	S	18	45	63	0.00001
Salegentibacter mishustinae	270918	S	982	1678	2660	0.00023
Salegentibacter sp. Hel_I_6	1250278	S	80	95	175	0.00002
Salegentibacter sp.	1903072	S	78	30	108	0.00001
Salegentibacter sp. R32	1486285	S	36	14	50	0.00000
Salegentibacter sp. 24	2183986	S	19	17	36	0.00000
Salegentibacter agarivorans	345907	S	120	137	257	0.00002
Salegentibacter maritimus	2794347	S	27	5	32	0.00000
Salegentibacter salarius	435906	S	13	15	28	0.00000
Mesonia oceanica	2687242	S	1361	397	1758	0.00015
Mesonia mobilis	369791	S	398	699	1097	0.00010
Mesonia sp.	1960830	S	41	60	101	0.00001
Mesonia aquimarina	1504967	S	23	10	33	0.00000
Joostella marina	453852	S	581	305	886	0.00008
Croceibacter atlanticus	313588	S	281	31	312	0.00003
Aequorivita sp.	1872390	S	88	87	175	0.00002
Aequorivita aquimaris	1548749	S	30	56	86	0.00001
Aquimarina sp.	1872586	S	219	37	256	0.00002
Aquimarina longa	1080221	S	16	2	18	0.00000
Maribacter cobaltidurans	1178778	S	124	82	206	0.00002
Maribacter dokdonensis	320912	S	29	7	36	0.00000
Mesoflavibacter zeaxanthinifaciens	393060	S	126	61	187	0.00002
Christiangramia flava	1486245	S	30	15	45	0.00000
Christiangramia forsetii	411153	S	27	10	37	0.00000
Christiangramia bathymodioli	2541727	S	21	10	31	0.00000
Euzebyella marina	1761453	S	95	68	163	0.00001
Arenibacter algicola	616991	S	38	26	64	0.00001
Marinirhabdus gelatinilytica	1703343	S	49	13	62	0.00001
Tenacibaculum sp. SG-28	754426	S	29	7	36	0.00000
Candidatus Ulvibacter alkanivorans	2267620	S	30	9	39	0.00000
Altibacter sp.	2024823	S	17	1	18	0.00000
Flavobacteriales bacterium UBA7878	1951087	S	5568	1398	6966	0.00061
Flavobacteriales bacterium	2021391	S	4686	569	5255	0.00046
Flavobacteriales bacterium UBA5081	1951031	S	70	5	75	0.00001
Flavobacteriales bacterium UBA852	1951088	S	32	1	33	0.00000
Flavobacteriales bacterium UBA6770	1951056	S	16	0	16	0.00000
Owenweeksia sp.	2024847	S	1117	31	1148	0.00010
Croceimicrobium hydrocarbonivorans	2761580	S	17	5	22	0.00000
Acidiluteibacter ferrifornacis	2692424	S	685	60	745	0.00006
Crocinitomicaceae bacterium	2026728	S	146	21	167	0.00001
uncultured Flavobacteriales bacterium	213322	S	33	4	37	0.00000
Bacteroidota bacterium	1898104	S	23920	2013	25933	0.00226
Bacteroidetes bacterium MED-G21	1986267	S	48	0	48	0.00000
Roseivirga spongicola	333140	S	201	24	225	0.00002
Roseivirga seohaensis	1914963	S	104	14	118	0.00001
Roseivirga pacifica	1267423	S	56	3	59	0.00001
Cyclobacterium marinum	104	S	218	50	268	0.00002
Algoriphagus iocasae	1836499	S	13	23	36	0.00000
Cytophagaceae bacterium	2026729	S	254	53	307	0.00003
Flammeovirgaceae bacterium UBA7330	1951792	S	84	16	100	0.00001
Flammeovirgaceae bacterium	2026740	S	66	19	85	0.00001
uncultured Marinoscillum sp.	932004	S	121	15	136	0.00001
Marivirga lumbricoides	1046115	S	36	12	48	0.00000
Marivirga atlantica	1548457	S	27	5	32	0.00000
Cytophagales bacterium Alg240-R148	2305985	S	12	0	12	0.00000
Cytophagia bacterium	2026730	S	13	14	27	0.00000
uncultured Bacteroidetes bacterium	152509	S	1220	250	1470	0.00013
Bacteroidales bacterium	2030927	S	852	74	926	0.00008
Lentimicrobiaceae bacterium	2026756	S	140	8	148	0.00001
Phaeodactylibacter xiamenensis	1524460	S	118	5	123	0.00001
Saprospirales bacterium	2026790	S	57	2	59	0.00001
Balneolaceae bacterium UBA7797	1951519	S	2575	235	2810	0.00024
Balneolaceae bacterium UBA3186	1951498	S	284	56	340	0.00003
Balneola sp.	2024824	S	55	68	123	0.00001
Ignavibacteriota bacterium	2026749	S	1474	38	1512	0.00013
Rubrivirga sp. SAORIC476	1961794	S	260	114	374	0.00003
Rhodothermales bacterium	2306054	S	27	0	27	0.00000
Rhodothermia bacterium	2497633	S	15	1	16	0.00000
Rhodothermaeota bacterium MED-G19	1986240	S	163	8	171	0.00001
Gemmatimonadota bacterium	2026742	S	52896	10097	62993	0.00549
Gemmatimonadaceae bacterium	2026741	S	22152	6513	28665	0.00250
Gemmatimonadales bacterium UBA7889	1951131	S	3344	10638	13982	0.00122
Gemmatimonadales bacterium UBA1120	1951099	S	1023	5983	7006	0.00061
Gemmatimonadales bacterium UBA2988	1951110	S	154	2	156	0.00001
Gemmatimonadales bacterium UBA1142	1951102	S	121	41	162	0.00001
Gemmatimonadales bacterium UBA2982	1951109	S	40	0	40	0.00000
Gemmatimonadales bacterium UBA2989	1951111	S	21	9	30	0.00000
Gemmatimonadales bacterium UBA2975	1951107	S	19	30	49	0.00000
Candidatus Latescibacteria bacterium	2053570	S	2019	169	2188	0.00019
Latescibacteria bacterium UBA6620	1948115	S	59	0	59	0.00001
Candidatus Hydrogenedentes bacterium	2030809	S	47	2	49	0.00000
Candidatus Microthrix sp. UBA2131	1946167	S	184059	189124	373183	0.03252
Candidatus Microthrix sp. UBA3125	1946176	S	90771	123599	214370	0.01868
Candidatus Microthrix sp. UBA4542	1946188	S	2955	1606	4561	0.00040
Candidatus Microthrix sp. UBA7884	1946214	S	2278	5541	7819	0.00068
Candidatus Microthrix sp. UBA672	1946197	S	86	65	151	0.00001
Candidatus Microthrix sp. UBA814	1946218	S	66	19	85	0.00001
Candidatus Microthrix sp. UBA2110	1946164	S	48	194	242	0.00002
Candidatus Microthrix sp. UBA7388	1946207	S	31	1	32	0.00000
Candidatus Microthrix sp. UBA2974	1946174	S	28	2	30	0.00000
Candidatus Microthrix sp. UBA825	1946219	S	21	3	24	0.00000
Candidatus Microthrix sp. UBA2983	1946175	S	18	10	28	0.00000
Candidatus Microthrix sp. UBA881	1946223	S	18	19	37	0.00000
Acidimicrobiaceae bacterium	2024894	S	16229	4815	21044	0.00183
Acidimicrobiales bacterium	2201156	S	785	334	1119	0.00010
Acidimicrobiales bacterium AG-410-I20	2162614	S	57	13	70	0.00001
Acidimicrobiales bacterium AG-414-N20	2162616	S	14	7	21	0.00000
Ilumatobacteraceae bacterium	2497619	S	250	203	453	0.00004
Acidimicrobiia bacterium	2080302	S	480	224	704	0.00006
Actinomycetia bacterium	1883427	S	101855	32051	133906	0.01167
OCS155 cluster bacterium AG-333-G23	2162605	S	88	61	149	0.00001
marine actinobacterium MedAcidi-G2B	1550401	S	13	2	15	0.00000
Microbacterium sp. UBA1097	1946941	S	3243	2927	6170	0.00054
Microbacterium sp.	51671	S	29	9	38	0.00000
Microbacterium luteum	2782167	S	173	212	385	0.00003
Microbacterium ginsengisoli	400772	S	20	9	29	0.00000
Microbacteriaceae bacterium UBA1487	1952239	S	1498	906	2404	0.00021
Marinisubtilis pacificus	2591847	S	289	261	550	0.00005
Chryseoglobus indicus	2750620	S	274	254	528	0.00005
Brevibacterium sp. W7.2	2823518	S	187	556	743	0.00006
Brevibacterium casei	33889	S	23	47	70	0.00001
Ornithinimicrobium sp. CNJ-824	1904966	S	368	150	518	0.00005
Serinicoccus chungangensis	767452	S	30	40	70	0.00001
Brachybacterium paraconglomeratum	173362	S	173	294	467	0.00004
Kocuria palustris	71999	S	32	34	66	0.00001
Micrococcus luteus	1270	S	27	49	76	0.00001
Dermacoccus nishinomiyaensis	1274	S	42	19	61	0.00001
Kytococcus sedentarius	1276	S	15	10	25	0.00000
Demequina sp. NBRC 110052	1570341	S	15	4	19	0.00000
Micrococcales bacterium	2026762	S	12	3	15	0.00000
Mycolicibacterium poriferae	39694	S	1168	2414	3582	0.00031
Mycolicibacterium hippocampi	659824	S	113	68	181	0.00002
Mycobacterium sp. PO1	1882219	S	85	168	253	0.00002
Gordonia sp. (in: high G+C Gram-positive bacteria)	84139	S	537	235	772	0.00007
Dietzia maris	37915	S	15	20	35	0.00000
Nocardioides sp.	35761	S	2442	631	3073	0.00027
Nocardioides sp. REDSEA-S33_B3	1811554	S	32	18	50	0.00000
Nocardioides salarius	374513	S	13	5	18	0.00000
Pimelobacter sp.	51662	S	16	18	34	0.00000
Cutibacterium acnes	1747	S	62	96	158	0.00001
uncultured Candidatus Actinomarina sp.	1985113	S	1919	932	2851	0.00025
Candidatus Actinomarinales bacterium	2510331	S	21	35	56	0.00000
Pseudonocardia alni	33907	S	22	23	45	0.00000
Euzebya pacifica	1608957	S	44	17	61	0.00001
Dehalococcoidia bacterium UBA2158	1948480	S	61409	26471	87880	0.00766
Dehalococcoidia bacterium UBA1122	1948466	S	17974	1165	19139	0.00167
Dehalococcoidia bacterium UBA2162	1948482	S	17491	1039	18530	0.00161
Dehalococcoidia bacterium UBA6495	1948511	S	15872	16538	32410	0.00282
Dehalococcoidia bacterium UBA7891	1948532	S	11023	5442	16465	0.00143
Dehalococcoidia bacterium	2026734	S	7433	848	8281	0.00072
Dehalococcoidia bacterium UBA7894	1948533	S	2376	1478	3854	0.00034
Dehalococcoidia bacterium UBA2160	1948481	S	645	96	741	0.00006
Dehalococcoidia bacterium UBA1152	1948471	S	351	118	469	0.00004
Dehalococcoidia bacterium UBA1332	1948476	S	313	260	573	0.00005
Dehalococcoidia bacterium UBA1151	1948470	S	239	21	260	0.00002
Dehalococcoidia bacterium UBA1123	1948467	S	234	249	483	0.00004
Dehalococcoidia bacterium UBA1141	1948469	S	115	18	133	0.00001
Dehalococcoidia bacterium UBA1127	1948468	S	53	1	54	0.00000
Dehalococcoidia bacterium UBA1328	1948475	S	15	4	19	0.00000
Dehalococcoidales bacterium	2026733	S	25733	2172	27905	0.00243
uncultured Dehalococcoidales bacterium	2006128	S	103	16	119	0.00001
Chloroflexota bacterium	2026724	S	71418	8296	79714	0.00695
Chloroflexi bacterium UBA6622	1947840	S	177	490	667	0.00006
SAR202 cluster bacterium	2030829	S	6937	3862	10799	0.00094
SAR202 cluster bacterium AC-647-N09_OGT_505m	2587833	S	263	9	272	0.00002
SAR202 cluster bacterium AC-409-J13_OGT_754m	2587834	S	177	2	179	0.00002
SAR202 cluster bacterium AC-647-P02_OGT_505m	2587832	S	24	8	32	0.00000
SAR202 cluster bacterium AD-804-J14_MRT_500m	2587836	S	20	0	20	0.00000
SAR202 cluster bacterium AG-426-M11	2162586	S	12	7	19	0.00000
Anaerolineales bacterium UBA1136	1950187	S	1526	233	1759	0.00015
Anaerolineales bacterium UBA832	1950226	S	96	80	176	0.00002
Anaerolineales bacterium UBA3001	1950202	S	25	117	142	0.00001
Anaerolineales bacterium UBA3499	1950205	S	16	64	80	0.00001
Anaerolineaceae bacterium	2024896	S	463	38	501	0.00004
Prochlorococcus sp. AG-402-O21	2162099	S	43	1235	1278	0.00011
Prochlorococcus sp. MIT 0701	1499502	S	25	267	292	0.00003
Prochlorococcus marinus	1219	S	37	1690	1727	0.00015
uncultured Prochlorococcus sp.	159733	S	24	2091	2115	0.00018
Cyanobium sp. ARS6	2024869	S	778	1133	1911	0.00017
Synechococcus sp. MIT S9220	166309	S	93	425	518	0.00005
Synechococcus sp. BIOS-E4-1	1400864	S	61	108	169	0.00001
Synechococcus sp. AG-679-A04	2161965	S	13	35	48	0.00000
Candidatus Margulisbacteria bacterium	2053573	S	34	6	40	0.00000
Candidatus Saganbacteria bacterium	2575572	S	28	0	28	0.00000
Marinococcus halotolerans	301092	S	59	164	223	0.00002
Marinococcus halophilus	1371	S	23	37	60	0.00001
Pseudalkalibacillus hwajinpoensis	208199	S	12	20	32	0.00000
Salinicoccus roseus	45670	S	99	65	164	0.00001
Staphylococcus hominis	1290	S	24	14	38	0.00000
Staphylococcus saprophyticus	29385	S	17	23	40	0.00000
Staphylococcus warneri	1292	S	16	29	45	0.00000
Jeotgalibacillus alimentarius	135826	S	22	20	42	0.00000
Marinilactibacillus piezotolerans	258723	S	36	13	49	0.00000
Mycoplasmatales bacterium	2023991	S	41	2	43	0.00000
Mycoplasmataceae bacterium	2685873	S	13	1	14	0.00000
SAR324 cluster bacterium SAR324-CTD7B	1795556	S	40815	232058	272873	0.02378
uncultured SAR324 cluster bacterium	179114	S	27986	45930	73916	0.00644
SAR324 cluster bacterium REDSEA-S27_B3	1811637	S	1278	119	1397	0.00012
SAR324 cluster bacterium	2024889	S	773	38	811	0.00007
SAR324 cluster bacterium lautmerah10	1764262	S	172	56	228	0.00002
Deltaproteobacteria bacterium	2026735	S	303612	28203	331815	0.02891
Acidobacteriota bacterium	1978231	S	303032	28268	331300	0.02887
Acidobacteria bacterium UBA823	1953113	S	1538	1261	2799	0.00024
Acidobacteria bacterium UBA2161	1953103	S	304	728	1032	0.00009
Acidobacteria bacterium UBA2999	1953107	S	126	12	138	0.00001
Acidobacteria bacterium UBA2994	1953106	S	21	37	58	0.00001
Acidobacteria bacterium UBA2990	1953105	S	12	6	18	0.00000
Kocuria sp. cx-455	2771377	S	19	16	35	0.00000
Candidatus Scalindua arabica	1127984	S	27046	14933	41979	0.00366
Candidatus Scalindua rubra	1872076	S	1006	239	1245	0.00011
Candidatus Scalindua sediminis	2798304	S	344	51	395	0.00003
Candidatus Scalindua sp.	2268189	S	88	70	158	0.00001
Candidatus Brocadiaceae bacterium S225	2528033	S	57	155	212	0.00002
Phycisphaerales bacterium	2052180	S	24369	5637	30006	0.00261
Phycisphaerales bacterium UBA7812	1951207	S	576	124	700	0.00006
Phycisphaerales bacterium UBA1910	1951186	S	366	51	417	0.00004
Phycisphaeraceae bacterium	2026777	S	71	24	95	0.00001
Phycisphaerae bacterium	2026778	S	8607	6387	14994	0.00131
Planctomycetaceae bacterium	2026779	S	30475	9618	40093	0.00349
Planctomycetaceae bacterium UBA2972	1952733	S	90	4	94	0.00001
Planctomycetaceae bacterium UBA7805	1952745	S	36	30	66	0.00001
Planctomycetaceae bacterium TMED10	1986833	S	20	4	24	0.00000
Rubinisphaera brasiliensis	119	S	310	24	334	0.00003
Gimesia panareensis	2527978	S	110	113	223	0.00002
Fuerstiella sp.	1936112	S	23	0	23	0.00000
Planctomycetales bacterium ZRK34	2723666	S	12	1	13	0.00000
Blastopirellula marina	124	S	597	19	616	0.00005
Rhodopirellula sp.	2024855	S	430	138	568	0.00005
Mariniblastus sp.	2005381	S	49	2	51	0.00000
Pirellulales bacterium	2715253	S	24	4	28	0.00000
Planctomycetota bacterium	2026780	S	16701	10024	26725	0.00233
Planctomycetes bacterium UBA7888	1948130	S	5844	247	6091	0.00053
Planctomycetes bacterium UBA1662	1948126	S	212	541	753	0.00007
Planctomycetes bacterium RIFCSPLOWO2_12_FULL_40_19	1801983	S	140	40	180	0.00002
Planctomycetes bacterium UBA1135	1948124	S	42	13	55	0.00000
Akkermansiaceae bacterium UBA7890	1951374	S	48684	26586	75270	0.00656
Akkermansiaceae bacterium UBA4145	1951361	S	19	38	57	0.00000
Akkermansiaceae bacterium UBA1506	1951351	S	13	4	17	0.00000
Verrucomicrobiales bacterium	2026801	S	6733	3227	9960	0.00087
Roseibacillus sp.	2024856	S	462	119	581	0.00005
Verrucomicrobiaceae bacterium	2026800	S	21	5	26	0.00000
Verrucomicrobia subdivision 3 bacterium	2052186	S	59	8	67	0.00001
Pedosphaera sp.	2024890	S	14	6	20	0.00000
uncultured Verrucomicrobiales bacterium	100234	S	27	6	33	0.00000
Verrucomicrobiae bacterium	2499141	S	17	5	22	0.00000
Verrucomicrobiota bacterium	2026799	S	10747	4665	15412	0.00134
Verrucomicrobia bacterium UBA673	1948281	S	118	722	840	0.00007
Verrucomicrobia bacterium UBA6775	1948282	S	52	430	482	0.00004
Opitutae bacterium	2026771	S	614	245	859	0.00007
Opitutae bacterium UBA1116	1948703	S	35	0	35	0.00000
Opitutae bacterium UBA7876	1948743	S	33	1	34	0.00000
Opitutae bacterium UBA3534	1948719	S	19	0	19	0.00000
Puniceicoccaceae bacterium	2026784	S	601	101	702	0.00006
uncultured Opitutales bacterium	592834	S	143	23	166	0.00001
Opitutaceae bacterium	2006848	S	86	13	99	0.00001
Opitutales bacterium	2026772	S	19	7	26	0.00000
uncultured Verrucomicrobiota bacterium	156588	S	277	154	431	0.00004
Chlamydiia bacterium	2052156	S	46	1	47	0.00000
Kiritimatiellaceae bacterium	2026752	S	16	0	16	0.00000
Candidatus Poribacteria bacterium	2026781	S	63085	2202	65287	0.00569
Parcubacteria group bacterium	2026774	S	25168	1843	27011	0.00235
Candidatus Uhrbacteria bacterium	2053634	S	1089	66	1155	0.00010
Candidatus Magasanikbacteria bacterium	2026717	S	1046	33	1079	0.00009
Candidatus Kaiserbacteria bacterium	2030810	S	18	1	19	0.00000
Patescibacteria group bacterium UBA6532	1948854	S	2986	18	3004	0.00026
Patescibacteria group bacterium UBA2163	1948796	S	1364	24	1388	0.00012
Patescibacteria group bacterium	2052139	S	583	35	618	0.00005
Patescibacteria group bacterium UBA2135	1948793	S	171	0	171	0.00001
Patescibacteria group bacterium UBA3466	1948809	S	94	1	95	0.00001
Candidatus Woesebacteria bacterium	2026804	S	95	2	97	0.00001
Candidatus Saccharibacteria bacterium	2026720	S	5423	276	5699	0.00050
Candidatus Saccharibacteria bacterium UBA4215	1953341	S	4445	202	4647	0.00040
Candidatus Saccharibacteria bacterium UBA2112	1953324	S	99	0	99	0.00001
Candidatus Aminicenantes bacterium	2052149	S	764	27	791	0.00007
Candidatus Peribacter sp. UBA2144	1961372	S	525	578	1103	0.00010
Candidatus Peribacter sp. UBA6535	1961374	S	139	7	146	0.00001
Candidatus Peregrinibacteria bacterium	2030811	S	13	2	15	0.00000
Candidatus Dadabacteria bacterium UBA1144	1953208	S	112	9	121	0.00001
Candidatus Binatota bacterium	2528255	S	21	17	38	0.00000
candidate division NC10 bacterium SPGG6	1842517	S	19	0	19	0.00000
Candidatus Aerophobetes bacterium Ae_b3a	2012485	S	13	13	26	0.00000
Nitrospinota bacterium	2026769	S	46038	3713	49751	0.00434
Candidatus Nitromaritima sp. SCGC AAA288-L16	913337	S	5980	1435	7415	0.00065
Nitrospinaceae bacterium UBA7883	1953054	S	2846	98	2944	0.00026
Nitrospinaceae bacterium	2358456	S	444	89	533	0.00005
Nitrospina sp.	2024844	S	2273	532	2805	0.00024
uncultured Nitrospinaceae bacterium	407034	S	38	24	62	0.00001
Desulfobacteraceae bacterium UBA2156	1961529	S	24701	12990	37691	0.00328
Candidatus Desulfobacula maris	2841694	S	320	198	518	0.00005
Desulfobacterales bacterium	2044940	S	155	41	196	0.00002
Halobacteriovoraceae bacterium	2026745	S	14849	399	15248	0.00133
Bacteriovoracaceae bacterium	2081706	S	72	15	87	0.00001
Micavibrio sp.	2024841	S	7110	1212	8322	0.00073
Micavibrio sp. TMED2	1986633	S	3647	3086	6733	0.00059
Micavibrio sp. UBA2638	1946917	S	584	166	750	0.00007
Micavibrio sp. TMED27	1986607	S	118	90	208	0.00002
Micavibrio sp. UBA1850	1946909	S	59	7	66	0.00001
Micavibrio sp. UBA1672	1946908	S	43	4	47	0.00000
Micavibrio sp. UBA2137	1946913	S	37	7	44	0.00000
Bdellovibrionaceae bacterium UBA6502	1961516	S	790	17	807	0.00007
Pseudobdellovibrionaceae bacterium	2026715	S	97	2	99	0.00001
Bdellovibrionaceae bacterium UBA6776	1961519	S	15	0	15	0.00000
Nitrospiraceae bacterium	2026770	S	20888	514	21402	0.00186
Nitrospiraceae bacterium UBA2166	1952976	S	1135	526	1661	0.00014
Nitrospira sp.	70125	S	63	3	66	0.00001
Nitrospirales bacterium	2358460	S	989	26	1015	0.00009
Spirochaetales bacterium	2026792	S	4494	180	4674	0.00041
Spirochaetaceae bacterium	1898206	S	769	32	801	0.00007
Spirochaeta sp. UBA1101	1947540	S	14	0	14	0.00000
Sandaracinus sp.	2024858	S	714	57	771	0.00007
Myxococcales bacterium	2026763	S	328	13	341	0.00003
Myxococcales bacterium UBA1660	1961462	S	56	5	61	0.00001
bacterium	1869227	S	888	897	1785	0.00016
bacterium TMED217	1986780	S	33	1	34	0.00000
Sulfurimonas sp.	2022749	S	509	53	562	0.00005
Fusobacteriia bacterium UBA1095	1948575	S	209	2	211	0.00002
uncultured PS1 clade bacterium	1118065	S	44	69	113	0.00001
uncultured bacterium	77133	S	27	48	75	0.00001
Marine Group I thaumarchaeote	2511932	S	35730	242057	277787	0.02421
Thaumarchaeota archaeon SCGC AAA007-O23	913333	S	10781	129551	140332	0.01223
uncultured marine group I thaumarchaeote	360837	S	857	2313	3170	0.00028
Marine Group I thaumarchaeote SCGC AAA799-O18	1502294	S	182	116	298	0.00003
Candidatus Nitrosopelagicus sp.	2026808	S	9153	55654	64807	0.00565
Candidatus Nitrosopelagicus brevis	1410606	S	17	29	46	0.00000
Thaumarchaeota archaeon UBA141	1915753	S	9066	8157	17223	0.00150
Nitrososphaerota archaeon	2026795	S	3315	5435	8750	0.00076
Candidatus Bathyarchaeota archaeon	2026714	S	18837	1113	19950	0.00174
Candidatus Methanosuratincola sp.	2495426	S	88	19	107	0.00001
Euryarchaeota archaeon UBA136	1915770	S	45515	37440	82955	0.00723
Euryarchaeota archaeon UBA488	1915775	S	711	474	1185	0.00010
Marine Group III euryarchaeote CG-Bathy1	1889001	S	104	11	115	0.00001
Euryarchaeota archaeon UBA528	1915914	S	12844	4784	17628	0.00154
Candidatus Poseidoniales archaeon	2163009	S	1048	279	1327	0.00012
Euryarchaeota archaeon UBA623	1915969	S	348	51	399	0.00003
Euryarchaeota archaeon UBA111	1915792	S	107	3	110	0.00001
Euryarchaeota archaeon UBA19	1915829	S	76	30	106	0.00001
Euryarchaeota archaeon UBA439	1915887	S	55	74	129	0.00001
Euryarchaeota archaeon UBA28	1915871	S	37	5	42	0.00000
Euryarchaeota archaeon UBA121	1915796	S	36	4	40	0.00000
Euryarchaeota archaeon UBA438	1915886	S	31	6	37	0.00000
Euryarchaeota archaeon UBA128	1915803	S	27	3	30	0.00000
Euryarchaeota archaeon UBA126	1915801	S	26	35	61	0.00001
Euryarchaeota archaeon UBA443	1915890	S	24	6	30	0.00000
Euryarchaeota archaeon UBA86	1915978	S	20	6	26	0.00000
Euryarchaeota archaeon UBA23	1915854	S	18	3	21	0.00000
Euryarchaeota archaeon UBA250	1915859	S	15	11	26	0.00000
Euryarchaeota archaeon UBA602	1915954	S	14	3	17	0.00000
Euryarchaeota archaeon UBA552	1915930	S	13	0	13	0.00000
Euryarchaeota archaeon UBA82	1915974	S	13	5	18	0.00000
Euryarchaeota archaeon UBA39	1915881	S	13	1	14	0.00000
Euryarchaeota archaeon UBA60	1915951	S	12	0	12	0.00000
Marine Group II euryarchaeote MED-G34	2007295	S	12	2	14	0.00000
Candidatus Thalassarchaeaceae archaeon	2670411	S	294	177	471	0.00004
Candidatus Thalassoarchaea betae	2599289	S	77	35	112	0.00001
uncultured Candidatus Poseidoniales archaeon	274854	S	77	35	112	0.00001
Candidatus Poseidoniaceae archaeon	2666346	S	41	20	61	0.00001
Euryarchaeota archaeon	2026739	S	69968	11252	81220	0.00708
Marine Group IV archaeon HikBin4	2675329	S	79	2	81	0.00001
Candidatus Pacearchaeota archaeon	2026773	S	36041	1697	37738	0.00329
Candidatus Woesearchaeota archaeon	2026803	S	1860	53	1913	0.00017
Candidatus Woesearchaeota archaeon UBA489	1916024	S	1363	9	1372	0.00012
Nanoarchaeota archaeon	2026764	S	520	20	540	0.00005
archaeon	1906665	S	15551	889	16440	0.00143
archaeon UBA543	1917432	S	16	0	16	0.00000
